NUTS2;LAU2_CODE;LAU2_NAME;YEAR;NATION_AUSTRIA;NATION_FOREIGN;NATION_TOTAL
AT31;40101;Linz;2011;160832;29057;189889
AT31;40201;Steyr;2011;32854;5351;38205
AT31;40301;Wels;2011;47891;10700;58591
AT31;40401;Altheim;2011;4429;355;4784
AT31;40402;Aspach;2011;2300;96;2396
AT31;40403;Auerbach;2011;482;43;525
AT31;40404;Braunau am Inn;2011;13794;2403;16197
AT31;40405;Burgkirchen;2011;2387;167;2554
AT31;40406;Eggelsberg;2011;2119;157;2276
AT31;40407;Feldkirchen bei Mattighofen;2011;1839;52;1891
AT31;40408;Franking;2011;849;81;930
AT31;40409;Geretsberg;2011;993;80;1073
AT31;40410;Gilgenberg am Weilhart;2011;1206;86;1292
AT31;40411;Haigermoos;2011;566;24;590
AT31;40412;Handenberg;2011;1250;54;1304
AT31;40413;Helpfau-Uttendorf;2011;2867;499;3366
AT31;40414;Hochburg-Ach;2011;2535;557;3092
AT31;40415;Höhnhart;2011;1335;34;1369
AT31;40416;Jeging;2011;625;46;671
AT31;40417;Kirchberg bei Mattighofen;2011;1065;54;1119
AT31;40418;Lengau;2011;4095;285;4380
AT31;40419;Lochen am See;2011;2420;68;2488
AT31;40420;Maria Schmolln;2011;1335;38;1373
AT31;40421;Mattighofen;2011;4381;1349;5730
AT31;40422;Mauerkirchen;2011;1968;331;2299
AT31;40423;Mining;2011;1093;53;1146
AT31;40424;Moosbach;2011;885;37;922
AT31;40425;Moosdorf;2011;1454;78;1532
AT31;40426;Munderfing;2011;2530;211;2741
AT31;40427;Neukirchen an der Enknach;2011;2001;92;2093
AT31;40428;Ostermiething;2011;2829;327;3156
AT31;40429;Palting;2011;870;34;904
AT31;40430;Perwang am Grabensee;2011;839;45;884
AT31;40431;Pfaffstätt;2011;880;120;1000
AT31;40432;Pischelsdorf am Engelbach;2011;1566;72;1638
AT31;40433;Polling im Innkreis;2011;880;62;942
AT31;40434;Roßbach;2011;931;19;950
AT31;40435;St. Georgen am Fillmannsbach;2011;390;8;398
AT31;40436;St. Johann am Walde;2011;1988;68;2056
AT31;40437;St. Pantaleon;2011;2749;344;3093
AT31;40438;St. Peter am Hart;2011;2164;257;2421
AT31;40439;St. Radegund;2011;528;35;563
AT31;40440;St. Veit im Innkreis;2011;391;15;406
AT31;40441;Schalchen;2011;3328;360;3688
AT31;40442;Schwand im Innkreis;2011;847;24;871
AT31;40443;Tarsdorf;2011;1893;105;1998
AT31;40444;Treubach;2011;691;27;718
AT31;40445;Überackern;2011;488;154;642
AT31;40446;Weng im Innkreis;2011;1309;56;1365
AT31;40501;Alkoven;2011;5106;262;5368
AT31;40502;Aschach an der Donau;2011;1962;229;2191
AT31;40503;Eferding;2011;3382;484;3866
AT31;40504;Fraham;2011;2124;94;2218
AT31;40505;Haibach ob der Donau;2011;1289;16;1305
AT31;40506;Hartkirchen;2011;3935;135;4070
AT31;40507;Hinzenbach;2011;1907;82;1989
AT31;40508;Prambachkirchen;2011;2745;81;2826
AT31;40509;Pupping;2011;1892;39;1931
AT31;40510;St. Marienkirchen an der Polsenz;2011;2177;67;2244
AT31;40511;Scharten;2011;2038;139;2177
AT31;40512;Stroheim;2011;1539;17;1556
AT31;40601;Freistadt;2011;7020;438;7458
AT31;40602;Grünbach;2011;1850;31;1881
AT31;40603;Gutau;2011;2629;39;2668
AT31;40604;Hagenberg im Mühlkreis;2011;2584;67;2651
AT31;40605;Hirschbach im Mühlkreis;2011;1114;13;1127
AT31;40606;Kaltenberg;2011;623;1;624
AT31;40607;Kefermarkt;2011;2014;41;2055
AT31;40608;Königswiesen;2011;3175;17;3192
AT31;40609;Lasberg;2011;2748;47;2795
AT31;40610;Leopoldschlag;2011;987;44;1031
AT31;40611;Liebenau;2011;1708;15;1723
AT31;40612;Neumarkt im Mühlkreis;2011;3022;56;3078
AT31;40613;Pierbach;2011;984;21;1005
AT31;40614;Pregarten;2011;4947;151;5098
AT31;40615;Rainbach im Mühlkreis;2011;2825;87;2912
AT31;40616;Sandl;2011;1435;17;1452
AT31;40617;St. Leonhard bei Freistadt;2011;1414;12;1426
AT31;40618;St. Oswald bei Freistadt;2011;2726;41;2767
AT31;40619;Schönau im Mühlkreis;2011;1869;12;1881
AT31;40620;Tragwein;2011;3019;63;3082
AT31;40621;Unterweißenbach;2011;2300;15;2315
AT31;40622;Unterweitersdorf;2011;1969;40;2009
AT31;40623;Waldburg;2011;1343;28;1371
AT31;40624;Wartberg ob der Aist;2011;3970;69;4039
AT31;40625;Weitersfelden;2011;1036;25;1061
AT31;40626;Windhaag bei Freistadt;2011;1581;71;1652
AT31;40627;Bad Zell;2011;2663;97;2760
AT31;40701;Altmünster;2011;9058;464;9522
AT31;40702;Bad Goisern am Hallstättersee;2011;7152;373;7525
AT31;40703;Bad Ischl;2011;12545;1331;13876
AT31;40704;Ebensee am Traunsee;2011;7448;369;7817
AT31;40705;Gmunden;2011;11556;1530;13086
AT31;40706;Gosau;2011;1691;91;1782
AT31;40707;Grünau im Almtal;2011;1959;142;2101
AT31;40708;Gschwandt;2011;2626;59;2685
AT31;40709;Hallstatt;2011;745;54;799
AT31;40710;Kirchham;2011;1856;52;1908
AT31;40711;Laakirchen;2011;8502;966;9468
AT31;40712;Obertraun;2011;652;65;717
AT31;40713;Ohlsdorf;2011;4617;263;4880
AT31;40714;Pinsdorf;2011;3355;288;3643
AT31;40715;Roitham am Traunfall;2011;1927;55;1982
AT31;40716;St. Konrad;2011;1061;21;1082
AT31;40717;St. Wolfgang im Salzkammergut;2011;2615;228;2843
AT31;40718;Traunkirchen;2011;1546;94;1640
AT31;40719;Scharnstein;2011;4455;284;4739
AT31;40720;Vorchdorf;2011;6856;452;7308
AT31;40801;Aistersheim;2011;806;35;841
AT31;40802;Bad Schallerbach;2011;3242;276;3518
AT31;40804;Eschenau im Hausruckkreis;2011;1069;14;1083
AT31;40805;Gallspach;2011;2204;398;2602
AT31;40806;Gaspoltshofen;2011;3313;173;3486
AT31;40807;Geboltskirchen;2011;1381;55;1436
AT31;40808;Grieskirchen;2011;4210;593;4803
AT31;40809;Haag am Hausruck;2011;1990;138;2128
AT31;40810;Heiligenberg;2011;680;8;688
AT31;40811;Hofkirchen an der Trattnach;2011;1487;109;1596
AT31;40812;Kallham;2011;2453;90;2543
AT31;40813;Kematen am Innbach;2011;1267;78;1345
AT31;40814;Meggenhofen;2011;1329;40;1369
AT31;40815;Michaelnbach;2011;1262;16;1278
AT31;40816;Natternbach;2011;2275;46;2321
AT31;40817;Neukirchen am Walde;2011;1598;32;1630
AT31;40818;Neumarkt im Hausruckkreis;2011;1330;154;1484
AT31;40820;Pötting;2011;537;3;540
AT31;40821;Pollham;2011;973;16;989
AT31;40822;Pram;2011;1692;38;1730
AT31;40823;Rottenbach;2011;1050;37;1087
AT31;40824;St. Agatha;2011;2124;20;2144
AT31;40825;St. Georgen bei Grieskirchen;2011;1143;25;1168
AT31;40826;St. Thomas;2011;489;1;490
AT31;40827;Schlüßlberg;2011;2832;127;2959
AT31;40828;Steegen;2011;1037;9;1046
AT31;40829;Taufkirchen an der Trattnach;2011;1953;41;1994
AT31;40830;Tollet;2011;888;18;906
AT31;40831;Waizenkirchen;2011;3478;143;3621
AT31;40832;Wallern an der Trattnach;2011;2721;142;2863
AT31;40833;Weibern;2011;1529;75;1604
AT31;40834;Wendling;2011;794;13;807
AT31;40835;Peuerbach;2011;4275;181;4456
AT31;40901;Edlbach;2011;624;22;646
AT31;40902;Grünburg;2011;3535;314;3849
AT31;40903;Hinterstoder;2011;852;64;916
AT31;40904;Inzersdorf im Kremstal;2011;1804;77;1881
AT31;40905;Kirchdorf an der Krems;2011;3689;386;4075
AT31;40906;Klaus an der Pyhrnbahn;2011;1020;86;1106
AT31;40907;Kremsmünster;2011;5752;706;6458
AT31;40908;Micheldorf in Oberösterreich;2011;5402;456;5858
AT31;40909;Molln;2011;3317;278;3595
AT31;40910;Nußbach;2011;2209;60;2269
AT31;40911;Oberschlierbach;2011;451;14;465
AT31;40912;Pettenbach;2011;4676;293;4969
AT31;40913;Ried im Traunkreis;2011;2564;83;2647
AT31;40914;Rosenau am Hengstpaß;2011;638;51;689
AT31;40915;Roßleithen;2011;1793;76;1869
AT31;40916;St. Pankraz;2011;328;30;358
AT31;40917;Schlierbach;2011;2646;130;2776
AT31;40918;Spital am Pyhrn;2011;2111;99;2210
AT31;40919;Steinbach am Ziehberg;2011;801;18;819
AT31;40920;Steinbach an der Steyr;2011;1923;54;1977
AT31;40921;Vorderstoder;2011;746;28;774
AT31;40922;Wartberg an der Krems;2011;2768;162;2930
AT31;40923;Windischgarsten;2011;2170;251;2421
AT31;41001;Allhaming;2011;1017;43;1060
AT31;41002;Ansfelden;2011;13137;2535;15672
AT31;41003;Asten;2011;5642;578;6220
AT31;41004;Eggendorf im Traunkreis;2011;733;43;776
AT31;41005;Enns;2011;9703;1658;11361
AT31;41006;Hargelsberg;2011;1196;35;1231
AT31;41007;Hörsching;2011;5310;470;5780
AT31;41008;Hofkirchen im Traunkreis;2011;1667;61;1728
AT31;41009;Kematen an der Krems;2011;2357;153;2510
AT31;41010;Kirchberg-Thening;2011;2241;57;2298
AT31;41011;Kronstorf;2011;2957;183;3140
AT31;41012;Leonding;2011;23116;2466;25582
AT31;41013;St. Florian;2011;5777;199;5976
AT31;41014;Neuhofen an der Krems;2011;5249;360;5609
AT31;41015;Niederneukirchen;2011;1883;45;1928
AT31;41016;Oftering;2011;1861;107;1968
AT31;41017;Pasching;2011;5936;648;6584
AT31;41018;Piberbach;2011;1772;73;1845
AT31;41019;Pucking;2011;3599;143;3742
AT31;41020;St. Marien;2011;4467;152;4619
AT31;41021;Traun;2011;19478;4231;23709
AT31;41022;Wilhering;2011;5479;299;5778
AT31;41101;Allerheiligen im Mühlkreis;2011;1173;12;1185
AT31;41102;Arbing;2011;1315;50;1365
AT31;41103;Baumgartenberg;2011;1552;57;1609
AT31;41104;Dimbach;2011;1028;16;1044
AT31;41105;Grein;2011;2852;172;3024
AT31;41106;Katsdorf;2011;2762;77;2839
AT31;41107;Klam;2011;891;19;910
AT31;41108;Bad Kreuzen;2011;2188;137;2325
AT31;41109;Langenstein;2011;2338;135;2473
AT31;41110;Luftenberg an der Donau;2011;3756;126;3882
AT31;41111;Mauthausen;2011;4397;548;4945
AT31;41112;Mitterkirchen im Machland;2011;1667;31;1698
AT31;41113;Münzbach;2011;1616;110;1726
AT31;41114;Naarn im Machlande;2011;3356;174;3530
AT31;41115;Pabneukirchen;2011;1697;34;1731
AT31;41116;Perg;2011;7052;771;7823
AT31;41117;Rechberg;2011;913;14;927
AT31;41118;Ried in der Riedmark;2011;4010;77;4087
AT31;41119;St. Georgen am Walde;2011;2076;18;2094
AT31;41120;St. Georgen an der Gusen;2011;3500;124;3624
AT31;41121;St. Nikola an der Donau;2011;672;79;751
AT31;41122;St. Thomas am Blasenstein;2011;914;23;937
AT31;41123;Saxen;2011;1663;70;1733
AT31;41124;Schwertberg;2011;4798;343;5141
AT31;41125;Waldhausen im Strudengau;2011;2797;105;2902
AT31;41126;Windhaag bei Perg;2011;1354;79;1433
AT31;41201;Andrichsfurt;2011;703;9;712
AT31;41202;Antiesenhofen;2011;973;114;1087
AT31;41203;Aurolzmünster;2011;2763;150;2913
AT31;41204;Eberschwang;2011;3221;164;3385
AT31;41205;Eitzing;2011;701;20;721
AT31;41206;Geiersberg;2011;535;10;545
AT31;41207;Geinberg;2011;1326;59;1385
AT31;41208;Gurten;2011;1087;87;1174
AT31;41209;Hohenzell;2011;1986;58;2044
AT31;41210;Kirchdorf am Inn;2011;580;26;606
AT31;41211;Kirchheim im Innkreis;2011;683;25;708
AT31;41212;Lambrechten;2011;1267;30;1297
AT31;41213;Lohnsburg am Kobernaußerwald;2011;2134;67;2201
AT31;41214;Mehrnbach;2011;2227;93;2320
AT31;41215;Mettmach;2011;2373;62;2435
AT31;41216;Mörschwang;2011;300;9;309
AT31;41217;Mühlheim am Inn;2011;595;34;629
AT31;41218;Neuhofen im Innkreis;2011;2122;91;2213
AT31;41219;Obernberg am Inn;2011;1267;181;1448
AT31;41220;Ort im Innkreis;2011;1135;86;1221
AT31;41221;Pattigham;2011;867;13;880
AT31;41222;Peterskirchen;2011;667;12;679
AT31;41223;Pramet;2011;978;46;1024
AT31;41224;Reichersberg;2011;1329;124;1453
AT31;41225;Ried im Innkreis;2011;9790;1604;11394
AT31;41226;St. Georgen bei Obernberg am Inn;2011;560;29;589
AT31;41227;St. Marienkirchen am Hausruck;2011;817;22;839
AT31;41228;St. Martin im Innkreis;2011;1517;259;1776
AT31;41229;Schildorn;2011;1088;13;1101
AT31;41230;Senftenbach;2011;698;40;738
AT31;41231;Taiskirchen im Innkreis;2011;2389;53;2442
AT31;41232;Tumeltsham;2011;1436;79;1515
AT31;41233;Utzenaich;2011;1461;75;1536
AT31;41234;Waldzell;2011;2042;44;2086
AT31;41235;Weilbach;2011;589;33;622
AT31;41236;Wippenham;2011;510;16;526
AT31;41304;Altenfelden;2011;2100;42;2142
AT31;41305;Arnreit;2011;1123;18;1141
AT31;41306;Atzesberg;2011;447;6;453
AT31;41307;Auberg;2011;581;12;593
AT31;41309;Haslach an der Mühl;2011;2463;69;2532
AT31;41311;Hörbich;2011;411;5;416
AT31;41312;Hofkirchen im Mühlkreis;2011;1398;42;1440
AT31;41313;Julbach;2011;1550;36;1586
AT31;41314;Kirchberg ob der Donau;2011;1047;12;1059
AT31;41315;Klaffer am Hochficht;2011;1252;47;1299
AT31;41316;Kleinzell im Mühlkreis;2011;1439;28;1467
AT31;41317;Kollerschlag;2011;1457;48;1505
AT31;41318;Lembach im Mühlkreis;2011;1492;66;1558
AT31;41319;Lichtenau im Mühlkreis;2011;511;7;518
AT31;41320;Nebelberg;2011;607;12;619
AT31;41321;Neufelden;2011;1174;99;1273
AT31;41322;Niederkappel;2011;973;4;977
AT31;41323;Niederwaldkirchen;2011;1731;27;1758
AT31;41324;Oberkappel;2011;656;77;733
AT31;41325;Oepping;2011;1530;13;1543
AT31;41326;Peilstein im Mühlviertel;2011;1568;27;1595
AT31;41327;Pfarrkirchen im Mühlkreis;2011;1442;67;1509
AT31;41328;Putzleinsdorf;2011;1490;56;1546
AT31;41329;Neustift im Mühlkreis;2011;1399;54;1453
AT31;41331;St. Johann am Wimberg;2011;981;22;1003
AT31;41332;St. Martin im Mühlkreis;2011;3526;86;3612
AT31;41333;St. Oswald bei Haslach;2011;490;7;497
AT31;41334;St. Peter am Wimberg;2011;1726;17;1743
AT31;41336;St. Ulrich im Mühlkreis;2011;659;14;673
AT31;41337;St. Veit im Mühlkreis;2011;1175;17;1192
AT31;41338;Sarleinsbach;2011;2208;28;2236
AT31;41341;Schwarzenberg am Böhmerwald;2011;577;61;638
AT31;41342;Ulrichsberg;2011;2882;78;2960
AT31;41343;Aigen-Schlägl;2011;3104;114;3218
AT31;41344;Rohrbach-Berg;2011;4805;209;5014
AT31;41345;Helfenberg;2011;1404;49;1453
AT31;41346;St. Stefan-Afiesl;2011;1197;19;1216
AT31;41401;Altschwendt;2011;654;11;665
AT31;41402;Andorf;2011;4826;234;5060
AT31;41403;Brunnenthal;2011;1837;138;1975
AT31;41404;Diersbach;2011;1563;51;1614
AT31;41405;Dorf an der Pram;2011;1010;19;1029
AT31;41406;Eggerding;2011;1215;27;1242
AT31;41407;Engelhartszell;2011;899;65;964
AT31;41408;Enzenkirchen;2011;1737;46;1783
AT31;41409;Esternberg;2011;2762;140;2902
AT31;41410;Freinberg;2011;1171;295;1466
AT31;41411;Kopfing im Innkreis;2011;1911;50;1961
AT31;41412;Mayrhof;2011;290;7;297
AT31;41413;Münzkirchen;2011;2498;58;2556
AT31;41414;Raab;2011;2184;86;2270
AT31;41415;Rainbach im Innkreis;2011;1483;35;1518
AT31;41416;Riedau;2011;1845;124;1969
AT31;41417;St. Aegidi;2011;1558;46;1604
AT31;41418;St. Florian am Inn;2011;2873;216;3089
AT31;41419;St. Marienkirchen bei Schärding;2011;1741;100;1841
AT31;41420;St. Roman;2011;1731;23;1754
AT31;41421;St. Willibald;2011;1097;26;1123
AT31;41422;Schärding;2011;4286;590;4876
AT31;41423;Schardenberg;2011;2044;243;2287
AT31;41424;Sigharting;2011;768;28;796
AT31;41425;Suben;2011;1183;215;1398
AT31;41426;Taufkirchen an der Pram;2011;2784;142;2926
AT31;41427;Vichtenstein;2011;567;120;687
AT31;41428;Waldkirchen am Wesen;2011;1186;29;1215
AT31;41429;Wernstein am Inn;2011;1410;136;1546
AT31;41430;Zell an der Pram;2011;1895;118;2013
AT31;41501;Adlwang;2011;1606;70;1676
AT31;41502;Aschach an der Steyr;2011;2188;25;2213
AT31;41503;Bad Hall;2011;4428;345;4773
AT31;41504;Dietach;2011;2801;171;2972
AT31;41505;Gaflenz;2011;1802;50;1852
AT31;41506;Garsten;2011;6409;274;6683
AT31;41507;Großraming;2011;2647;40;2687
AT31;41508;Laussa;2011;1270;8;1278
AT31;41509;Losenstein;2011;1590;41;1631
AT31;41510;Maria Neustift;2011;1629;8;1637
AT31;41511;Pfarrkirchen bei Bad Hall;2011;2072;71;2143
AT31;41512;Reichraming;2011;1783;23;1806
AT31;41513;Rohr im Kremstal;2011;1173;32;1205
AT31;41514;St. Ulrich bei Steyr;2011;2936;65;3001
AT31;41515;Schiedlberg;2011;1193;50;1243
AT31;41516;Sierning;2011;8595;520;9115
AT31;41517;Ternberg;2011;3248;60;3308
AT31;41518;Waldneukirchen;2011;2171;75;2246
AT31;41521;Wolfern;2011;2949;56;3005
AT31;41522;Weyer;2011;4106;120;4226
AT31;41601;Alberndorf in der Riedmark;2011;3797;75;3872
AT31;41602;Altenberg bei Linz;2011;4294;97;4391
AT31;41603;Bad Leonfelden;2011;3926;160;4086
AT31;41604;Eidenberg;2011;2000;44;2044
AT31;41605;Engerwitzdorf;2011;8324;194;8518
AT31;41606;Feldkirchen an der Donau;2011;4995;139;5134
AT31;41607;Gallneukirchen;2011;5951;232;6183
AT31;41608;Goldwörth;2011;912;18;930
AT31;41609;Gramastetten;2011;4615;130;4745
AT31;41610;Haibach im Mühlkreis;2011;835;27;862
AT31;41611;Hellmonsödt;2011;2085;75;2160
AT31;41612;Herzogsdorf;2011;2410;22;2432
AT31;41613;Kirchschlag bei Linz;2011;1934;87;2021
AT31;41614;Lichtenberg;2011;2545;43;2588
AT31;41615;Oberneukirchen;2011;3107;53;3160
AT31;41616;Ottenschlag im Mühlkreis;2011;503;6;509
AT31;41617;Ottensheim;2011;4283;220;4503
AT31;41618;Puchenau;2011;4271;162;4433
AT31;41619;Reichenau im Mühlkreis;2011;1216;22;1238
AT31;41620;Reichenthal;2011;1448;23;1471
AT31;41621;St. Gotthard im Mühlkreis;2011;1254;25;1279
AT31;41622;Schenkenfelden;2011;1515;20;1535
AT31;41623;Sonnberg im Mühlkreis;2011;855;6;861
AT31;41624;Steyregg;2011;4572;207;4779
AT31;41626;Walding;2011;3758;140;3898
AT31;41627;Zwettl an der Rodl;2011;1686;42;1728
AT31;41628;Vorderweißenbach;2011;2517;41;2558
AT31;41701;Ampflwang im Hausruckwald;2011;3195;255;3450
AT31;41702;Attersee am Attersee;2011;1489;96;1585
AT31;41703;Attnang-Puchheim;2011;7292;1570;8862
AT31;41704;Atzbach;2011;1144;27;1171
AT31;41705;Aurach am Hongar;2011;1543;56;1599
AT31;41706;Berg im Attergau;2011;966;40;1006
AT31;41707;Desselbrunn;2011;1646;44;1690
AT31;41708;Fornach;2011;911;24;935
AT31;41709;Frankenburg am Hausruck;2011;4636;166;4802
AT31;41710;Frankenmarkt;2011;3226;272;3498
AT31;41711;Gampern;2011;2626;75;2701
AT31;41712;Innerschwand am Mondsee;2011;1053;60;1113
AT31;41713;Lenzing;2011;4578;393;4971
AT31;41714;Manning;2011;799;9;808
AT31;41715;Mondsee;2011;2786;526;3312
AT31;41716;Neukirchen an der Vöckla;2011;2436;49;2485
AT31;41717;Niederthalheim;2011;1001;27;1028
AT31;41718;Nußdorf am Attersee;2011;1011;98;1109
AT31;41719;Oberhofen am Irrsee;2011;1428;70;1498
AT31;41720;Oberndorf bei Schwanenstadt;2011;1352;58;1410
AT31;41721;Oberwang;2011;1564;35;1599
AT31;41722;Ottnang am Hausruck;2011;3702;145;3847
AT31;41723;Pfaffing;2011;1380;28;1408
AT31;41724;Pilsbach;2011;621;5;626
AT31;41725;Pitzenberg;2011;488;7;495
AT31;41726;Pöndorf;2011;2202;80;2282
AT31;41727;Puchkirchen am Trattberg;2011;939;28;967
AT31;41728;Pühret;2011;587;5;592
AT31;41729;Redleiten;2011;483;11;494
AT31;41730;Redlham;2011;1397;79;1476
AT31;41731;Regau;2011;5819;436;6255
AT31;41732;Rüstorf;2011;1877;82;1959
AT31;41733;Rutzenham;2011;249;5;254
AT31;41734;St. Georgen im Attergau;2011;3630;483;4113
AT31;41735;St. Lorenz;2011;2170;166;2336
AT31;41736;Schlatt;2011;1247;67;1314
AT31;41737;Schörfling am Attersee;2011;3035;173;3208
AT31;41738;Schwanenstadt;2011;3496;624;4120
AT31;41739;Seewalchen am Attersee;2011;5042;269;5311
AT31;41740;Steinbach am Attersee;2011;791;60;851
AT31;41741;Straß im Attergau;2011;1368;106;1474
AT31;41742;Tiefgraben;2011;3467;266;3733
AT31;41743;Timelkam;2011;5402;539;5941
AT31;41744;Ungenach;2011;1387;31;1418
AT31;41745;Unterach am Attersee;2011;1277;150;1427
AT31;41746;Vöcklabruck;2011;10430;1479;11909
AT31;41747;Vöcklamarkt;2011;4396;367;4763
AT31;41748;Weißenkirchen im Attergau;2011;900;30;930
AT31;41749;Weyregg am Attersee;2011;1448;42;1490
AT31;41750;Wolfsegg am Hausruck;2011;1896;125;2021
AT31;41751;Zell am Moos;2011;1402;122;1524
AT31;41752;Zell am Pettenfirst;2011;1100;46;1146
AT31;41801;Aichkirchen;2011;521;28;549
AT31;41802;Bachmanning;2011;604;61;665
AT31;41803;Bad Wimsbach-Neydharting;2011;2326;108;2434
AT31;41804;Buchkirchen;2011;3870;174;4044
AT31;41805;Eberstalzell;2011;2235;102;2337
AT31;41806;Edt bei Lambach;2011;1893;130;2023
AT31;41807;Fischlham;2011;1288;30;1318
AT31;41808;Gunskirchen;2011;5327;362;5689
AT31;41809;Holzhausen;2011;751;32;783
AT31;41810;Krenglbach;2011;2879;101;2980
AT31;41811;Lambach;2011;2803;541;3344
AT31;41812;Marchtrenk;2011;11093;1266;12359
AT31;41813;Neukirchen bei Lambach;2011;865;21;886
AT31;41814;Offenhausen;2011;1515;92;1607
AT31;41815;Pennewang;2011;864;15;879
AT31;41816;Pichl bei Wels;2011;2606;189;2795
AT31;41817;Sattledt;2011;2221;189;2410
AT31;41818;Schleißheim;2011;1181;55;1236
AT31;41819;Sipbachzell;2011;1725;73;1798
AT31;41820;Stadl-Paura;2011;4232;699;4931
AT31;41821;Steinerkirchen an der Traun;2011;2271;74;2345
AT31;41822;Steinhaus;2011;1822;55;1877
AT31;41823;Thalheim bei Wels;2011;5060;444;5504
AT31;41824;Weißkirchen an der Traun;2011;2971;181;3152
AT31;40101;Linz;2001;161378;22126;183504
AT31;40201;Steyr;2001;34376;4964;39340
AT31;40301;Wels;2001;47519;8959;56478
AT31;40401;Altheim;2001;4551;324;4875
AT31;40402;Aspach;2001;2281;58;2339
AT31;40403;Auerbach;2001;493;11;504
AT31;40404;Braunau am Inn;2001;14439;1898;16337
AT31;40405;Burgkirchen;2001;2419;127;2546
AT31;40406;Eggelsberg;2001;1948;157;2105
AT31;40407;Feldkirchen bei Mattighofen;2001;1779;50;1829
AT31;40408;Franking;2001;786;59;845
AT31;40409;Geretsberg;2001;991;72;1063
AT31;40410;Gilgenberg am Weilhart;2001;1174;47;1221
AT31;40411;Haigermoos;2001;526;19;545
AT31;40412;Handenberg;2001;1271;58;1329
AT31;40413;Helpfau-Uttendorf;2001;2830;413;3243
AT31;40414;Hochburg-Ach;2001;2682;296;2978
AT31;40415;Höhnhart;2001;1392;5;1397
AT31;40416;Jeging;2001;541;54;595
AT31;40417;Kirchberg bei Mattighofen;2001;997;11;1008
AT31;40418;Lengau;2001;4082;329;4411
AT31;40419;Lochen am See;2001;2241;76;2317
AT31;40420;Maria Schmolln;2001;1252;19;1271
AT31;40421;Mattighofen;2001;4213;874;5087
AT31;40422;Mauerkirchen;2001;1976;321;2297
AT31;40423;Mining;2001;1134;32;1166
AT31;40424;Moosbach;2001;863;53;916
AT31;40425;Moosdorf;2001;1330;58;1388
AT31;40426;Munderfing;2001;2482;198;2680
AT31;40427;Neukirchen an der Enknach;2001;2025;77;2102
AT31;40428;Ostermiething;2001;2644;236;2880
AT31;40429;Palting;2001;852;15;867
AT31;40430;Perwang am Grabensee;2001;699;19;718
AT31;40431;Pfaffstätt;2001;847;101;948
AT31;40432;Pischelsdorf am Engelbach;2001;1592;49;1641
AT31;40433;Polling im Innkreis;2001;868;51;919
AT31;40434;Roßbach;2001;926;17;943
AT31;40435;St. Georgen am Fillmannsbach;2001;391;8;399
AT31;40436;St. Johann am Walde;2001;2041;23;2064
AT31;40437;St. Pantaleon;2001;2725;329;3054
AT31;40438;St. Peter am Hart;2001;2197;197;2394
AT31;40439;St. Radegund;2001;563;17;580
AT31;40440;St. Veit im Innkreis;2001;365;1;366
AT31;40441;Schalchen;2001;3292;218;3510
AT31;40442;Schwand im Innkreis;2001;828;18;846
AT31;40443;Tarsdorf;2001;1856;82;1938
AT31;40444;Treubach;2001;740;9;749
AT31;40445;Überackern;2001;537;53;590
AT31;40446;Weng im Innkreis;2001;1353;36;1389
AT31;40501;Alkoven;2001;4878;313;5191
AT31;40502;Aschach an der Donau;2001;1897;249;2146
AT31;40503;Eferding;2001;3088;305;3393
AT31;40504;Fraham;2001;1907;75;1982
AT31;40505;Haibach ob der Donau;2001;1274;8;1282
AT31;40506;Hartkirchen;2001;4012;174;4186
AT31;40507;Hinzenbach;2001;1855;120;1975
AT31;40508;Prambachkirchen;2001;2721;78;2799
AT31;40509;Pupping;2001;1786;117;1903
AT31;40510;St. Marienkirchen an der Polsenz;2001;2140;52;2192
AT31;40511;Scharten;2001;1959;150;2109
AT31;40512;Stroheim;2001;1551;9;1560
AT31;40601;Freistadt;2001;6923;430;7353
AT31;40602;Grünbach;2001;1770;46;1816
AT31;40603;Gutau;2001;2610;40;2650
AT31;40604;Hagenberg im Mühlkreis;2001;2466;47;2513
AT31;40605;Hirschbach im Mühlkreis;2001;1174;12;1186
AT31;40606;Kaltenberg;2001;655;0;655
AT31;40607;Kefermarkt;2001;2014;42;2056
AT31;40608;Königswiesen;2001;3107;16;3123
AT31;40609;Lasberg;2001;2702;41;2743
AT31;40610;Leopoldschlag;2001;1022;64;1086
AT31;40611;Liebenau;2001;1826;15;1841
AT31;40612;Neumarkt im Mühlkreis;2001;3027;44;3071
AT31;40613;Pierbach;2001;978;8;986
AT31;40614;Pregarten;2001;4701;114;4815
AT31;40615;Rainbach im Mühlkreis;2001;2827;107;2934
AT31;40616;Sandl;2001;1512;19;1531
AT31;40617;St. Leonhard bei Freistadt;2001;1467;9;1476
AT31;40618;St. Oswald bei Freistadt;2001;2645;61;2706
AT31;40619;Schönau im Mühlkreis;2001;1811;7;1818
AT31;40620;Tragwein;2001;2921;50;2971
AT31;40621;Unterweißenbach;2001;2288;11;2299
AT31;40622;Unterweitersdorf;2001;1688;16;1704
AT31;40623;Waldburg;2001;1346;11;1357
AT31;40624;Wartberg ob der Aist;2001;3675;56;3731
AT31;40625;Weitersfelden;2001;1127;10;1137
AT31;40626;Windhaag bei Freistadt;2001;1674;60;1734
AT31;40627;Bad Zell;2001;2673;43;2716
AT31;40701;Altmünster;2001;9037;408;9445
AT31;40702;Bad Goisern am Hallstättersee;2001;7225;377;7602
AT31;40703;Bad Ischl;2001;12746;1335;14081
AT31;40704;Ebensee am Traunsee;2001;8061;391;8452
AT31;40705;Gmunden;2001;11651;1533;13184
AT31;40706;Gosau;2001;1874;70;1944
AT31;40707;Grünau im Almtal;2001;1991;120;2111
AT31;40708;Gschwandt;2001;2352;72;2424
AT31;40709;Hallstatt;2001;883;63;946
AT31;40710;Kirchham;2001;1829;84;1913
AT31;40711;Laakirchen;2001;8143;987;9130
AT31;40712;Obertraun;2001;737;29;766
AT31;40713;Ohlsdorf;2001;4345;183;4528
AT31;40714;Pinsdorf;2001;3234;209;3443
AT31;40715;Roitham am Traunfall;2001;1905;91;1996
AT31;40716;St. Konrad;2001;1023;7;1030
AT31;40717;St. Wolfgang im Salzkammergut;2001;2620;178;2798
AT31;40718;Traunkirchen;2001;1655;109;1764
AT31;40719;Scharnstein;2001;4278;255;4533
AT31;40720;Vorchdorf;2001;6696;569;7265
AT31;40801;Aistersheim;2001;744;42;786
AT31;40802;Bad Schallerbach;2001;3075;200;3275
AT31;40804;Eschenau im Hausruckkreis;2001;1160;14;1174
AT31;40805;Gallspach;2001;2216;355;2571
AT31;40806;Gaspoltshofen;2001;3453;144;3597
AT31;40807;Geboltskirchen;2001;1367;43;1410
AT31;40808;Grieskirchen;2001;4250;552;4802
AT31;40809;Haag am Hausruck;2001;1889;151;2040
AT31;40810;Heiligenberg;2001;706;2;708
AT31;40811;Hofkirchen an der Trattnach;2001;1406;102;1508
AT31;40812;Kallham;2001;2474;62;2536
AT31;40813;Kematen am Innbach;2001;1184;77;1261
AT31;40814;Meggenhofen;2001;1200;33;1233
AT31;40815;Michaelnbach;2001;1220;10;1230
AT31;40816;Natternbach;2001;2290;47;2337
AT31;40817;Neukirchen am Walde;2001;1658;22;1680
AT31;40818;Neumarkt im Hausruckkreis;2001;1316;122;1438
AT31;40820;Pötting;2001;529;10;539
AT31;40821;Pollham;2001;900;14;914
AT31;40822;Pram;2001;1757;80;1837
AT31;40823;Rottenbach;2001;965;45;1010
AT31;40824;St. Agatha;2001;2110;11;2121
AT31;40825;St. Georgen bei Grieskirchen;2001;937;23;960
AT31;40826;St. Thomas;2001;451;8;459
AT31;40827;Schlüßlberg;2001;2885;114;2999
AT31;40828;Steegen;2001;1111;10;1121
AT31;40829;Taufkirchen an der Trattnach;2001;2013;74;2087
AT31;40830;Tollet;2001;855;12;867
AT31;40831;Waizenkirchen;2001;3544;109;3653
AT31;40832;Wallern an der Trattnach;2001;2766;99;2865
AT31;40833;Weibern;2001;1472;109;1581
AT31;40834;Wendling;2001;825;6;831
AT31;40835;Peuerbach;2001;4338;192;4530
AT31;40901;Edlbach;2001;627;53;680
AT31;40902;Grünburg;2001;3472;352;3824
AT31;40903;Hinterstoder;2001;925;76;1001
AT31;40904;Inzersdorf im Kremstal;2001;1749;81;1830
AT31;40905;Kirchdorf an der Krems;2001;3677;422;4099
AT31;40906;Klaus an der Pyhrnbahn;2001;1070;108;1178
AT31;40907;Kremsmünster;2001;5625;811;6436
AT31;40908;Micheldorf in Oberösterreich;2001;5160;429;5589
AT31;40909;Molln;2001;3407;316;3723
AT31;40910;Nußbach;2001;2200;44;2244
AT31;40911;Oberschlierbach;2001;447;15;462
AT31;40912;Pettenbach;2001;4389;351;4740
AT31;40913;Ried im Traunkreis;2001;2319;93;2412
AT31;40914;Rosenau am Hengstpaß;2001;676;65;741
AT31;40915;Roßleithen;2001;1757;74;1831
AT31;40916;St. Pankraz;2001;364;26;390
AT31;40917;Schlierbach;2001;2556;156;2712
AT31;40918;Spital am Pyhrn;2001;2175;100;2275
AT31;40919;Steinbach am Ziehberg;2001;851;2;853
AT31;40920;Steinbach an der Steyr;2001;1985;42;2027
AT31;40921;Vorderstoder;2001;746;15;761
AT31;40922;Wartberg an der Krems;2001;2797;214;3011
AT31;40923;Windischgarsten;2001;2175;173;2348
AT31;41001;Allhaming;2001;967;60;1027
AT31;41002;Ansfelden;2001;13138;1651;14789
AT31;41003;Asten;2001;5642;383;6025
AT31;41004;Eggendorf im Traunkreis;2001;683;15;698
AT31;41005;Enns;2001;9234;1377;10611
AT31;41006;Hargelsberg;2001;1056;26;1082
AT31;41007;Hörsching;2001;4905;328;5233
AT31;41008;Hofkirchen im Traunkreis;2001;1337;57;1394
AT31;41009;Kematen an der Krems;2001;2063;162;2225
AT31;41010;Kirchberg-Thening;2001;2110;20;2130
AT31;41011;Kronstorf;2001;2878;124;3002
AT31;41012;Leonding;2001;20485;1718;22203
AT31;41013;St. Florian;2001;5339;191;5530
AT31;41014;Neuhofen an der Krems;2001;5050;353;5403
AT31;41015;Niederneukirchen;2001;1754;26;1780
AT31;41016;Oftering;2001;1771;53;1824
AT31;41017;Pasching;2001;5679;444;6123
AT31;41018;Piberbach;2001;1661;44;1705
AT31;41019;Pucking;2001;3345;129;3474
AT31;41020;St. Marien;2001;4018;122;4140
AT31;41021;Traun;2001;19885;3585;23470
AT31;41022;Wilhering;2001;4951;240;5191
AT31;41101;Allerheiligen im Mühlkreis;2001;1093;6;1099
AT31;41102;Arbing;2001;1242;42;1284
AT31;41103;Baumgartenberg;2001;1366;33;1399
AT31;41104;Dimbach;2001;1092;11;1103
AT31;41105;Grein;2001;2956;153;3109
AT31;41106;Katsdorf;2001;2680;53;2733
AT31;41107;Klam;2001;779;10;789
AT31;41108;Bad Kreuzen;2001;2126;205;2331
AT31;41109;Langenstein;2001;2432;213;2645
AT31;41110;Luftenberg an der Donau;2001;3596;69;3665
AT31;41111;Mauthausen;2001;4430;415;4845
AT31;41112;Mitterkirchen im Machland;2001;1748;45;1793
AT31;41113;Münzbach;2001;1604;95;1699
AT31;41114;Naarn im Machlande;2001;3173;138;3311
AT31;41115;Pabneukirchen;2001;1682;43;1725
AT31;41116;Perg;2001;6499;630;7129
AT31;41117;Rechberg;2001;856;21;877
AT31;41118;Ried in der Riedmark;2001;3641;114;3755
AT31;41119;St. Georgen am Walde;2001;2224;10;2234
AT31;41120;St. Georgen an der Gusen;2001;3372;157;3529
AT31;41121;St. Nikola an der Donau;2001;768;85;853
AT31;41122;St. Thomas am Blasenstein;2001;853;23;876
AT31;41123;Saxen;2001;1709;71;1780
AT31;41124;Schwertberg;2001;4718;446;5164
AT31;41125;Waldhausen im Strudengau;2001;2859;60;2919
AT31;41126;Windhaag bei Perg;2001;1261;48;1309
AT31;41201;Andrichsfurt;2001;697;27;724
AT31;41202;Antiesenhofen;2001;985;120;1105
AT31;41203;Aurolzmünster;2001;2667;184;2851
AT31;41204;Eberschwang;2001;3228;145;3373
AT31;41205;Eitzing;2001;650;8;658
AT31;41206;Geiersberg;2001;528;11;539
AT31;41207;Geinberg;2001;1250;67;1317
AT31;41208;Gurten;2001;1134;94;1228
AT31;41209;Hohenzell;2001;1958;41;1999
AT31;41210;Kirchdorf am Inn;2001;600;30;630
AT31;41211;Kirchheim im Innkreis;2001;692;12;704
AT31;41212;Lambrechten;2001;1322;28;1350
AT31;41213;Lohnsburg am Kobernaußerwald;2001;2277;47;2324
AT31;41214;Mehrnbach;2001;2246;56;2302
AT31;41215;Mettmach;2001;2521;36;2557
AT31;41216;Mörschwang;2001;291;3;294
AT31;41217;Mühlheim am Inn;2001;643;6;649
AT31;41218;Neuhofen im Innkreis;2001;2060;65;2125
AT31;41219;Obernberg am Inn;2001;1537;166;1703
AT31;41220;Ort im Innkreis;2001;1112;69;1181
AT31;41221;Pattigham;2001;800;9;809
AT31;41222;Peterskirchen;2001;694;15;709
AT31;41223;Pramet;2001;951;37;988
AT31;41224;Reichersberg;2001;1321;78;1399
AT31;41225;Ried im Innkreis;2001;10049;1355;11404
AT31;41226;St. Georgen bei Obernberg am Inn;2001;577;26;603
AT31;41227;St. Marienkirchen am Hausruck;2001;715;19;734
AT31;41228;St. Martin im Innkreis;2001;1487;206;1693
AT31;41229;Schildorn;2001;1017;34;1051
AT31;41230;Senftenbach;2001;680;18;698
AT31;41231;Taiskirchen im Innkreis;2001;2378;28;2406
AT31;41232;Tumeltsham;2001;1315;37;1352
AT31;41233;Utzenaich;2001;1408;88;1496
AT31;41234;Waldzell;2001;2049;48;2097
AT31;41235;Weilbach;2001;588;9;597
AT31;41236;Wippenham;2001;543;11;554
AT31;41304;Altenfelden;2001;2153;80;2233
AT31;41305;Arnreit;2001;1095;9;1104
AT31;41306;Atzesberg;2001;493;28;521
AT31;41307;Auberg;2001;528;7;535
AT31;41309;Haslach an der Mühl;2001;2512;58;2570
AT31;41311;Hörbich;2001;437;3;440
AT31;41312;Hofkirchen im Mühlkreis;2001;1417;19;1436
AT31;41313;Julbach;2001;1621;33;1654
AT31;41314;Kirchberg ob der Donau;2001;1085;38;1123
AT31;41315;Klaffer am Hochficht;2001;1306;27;1333
AT31;41316;Kleinzell im Mühlkreis;2001;1369;23;1392
AT31;41317;Kollerschlag;2001;1479;52;1531
AT31;41318;Lembach im Mühlkreis;2001;1452;81;1533
AT31;41319;Lichtenau im Mühlkreis;2001;567;2;569
AT31;41320;Nebelberg;2001;623;18;641
AT31;41321;Neufelden;2001;1155;87;1242
AT31;41322;Niederkappel;2001;1011;28;1039
AT31;41323;Niederwaldkirchen;2001;1768;23;1791
AT31;41324;Oberkappel;2001;698;68;766
AT31;41325;Oepping;2001;1606;31;1637
AT31;41326;Peilstein im Mühlviertel;2001;1623;51;1674
AT31;41327;Pfarrkirchen im Mühlkreis;2001;1492;59;1551
AT31;41328;Putzleinsdorf;2001;1504;81;1585
AT31;41329;Neustift im Mühlkreis;2001;1442;51;1493
AT31;41331;St. Johann am Wimberg;2001;996;19;1015
AT31;41332;St. Martin im Mühlkreis;2001;3413;175;3588
AT31;41333;St. Oswald bei Haslach;2001;561;6;567
AT31;41334;St. Peter am Wimberg;2001;1746;17;1763
AT31;41336;St. Ulrich im Mühlkreis;2001;595;7;602
AT31;41337;St. Veit im Mühlkreis;2001;1143;5;1148
AT31;41338;Sarleinsbach;2001;2323;32;2355
AT31;41341;Schwarzenberg am Böhmerwald;2001;626;67;693
AT31;41342;Ulrichsberg;2001;2987;77;3064
AT31;41343;Aigen-Schlägl;2001;3172;152;3324
AT31;41344;Rohrbach-Berg;2001;4864;167;5031
AT31;41345;Helfenberg;2001;1503;42;1545
AT31;41346;St. Stefan-Afiesl;2001;1244;23;1267
AT31;41401;Altschwendt;2001;644;34;678
AT31;41402;Andorf;2001;4688;160;4848
AT31;41403;Brunnenthal;2001;1782;141;1923
AT31;41404;Diersbach;2001;1646;47;1693
AT31;41405;Dorf an der Pram;2001;992;24;1016
AT31;41406;Eggerding;2001;1264;50;1314
AT31;41407;Engelhartszell;2001;1061;108;1169
AT31;41408;Enzenkirchen;2001;1716;39;1755
AT31;41409;Esternberg;2001;2723;93;2816
AT31;41410;Freinberg;2001;1260;180;1440
AT31;41411;Kopfing im Innkreis;2001;1975;54;2029
AT31;41412;Mayrhof;2001;257;0;257
AT31;41413;Münzkirchen;2001;2480;93;2573
AT31;41414;Raab;2001;2183;88;2271
AT31;41415;Rainbach im Innkreis;2001;1476;15;1491
AT31;41416;Riedau;2001;1880;133;2013
AT31;41417;St. Aegidi;2001;1621;22;1643
AT31;41418;St. Florian am Inn;2001;2816;174;2990
AT31;41419;St. Marienkirchen bei Schärding;2001;1754;82;1836
AT31;41420;St. Roman;2001;1778;17;1795
AT31;41421;St. Willibald;2001;1107;32;1139
AT31;41422;Schärding;2001;4603;449;5052
AT31;41423;Schardenberg;2001;2134;250;2384
AT31;41424;Sigharting;2001;787;41;828
AT31;41425;Suben;2001;1217;183;1400
AT31;41426;Taufkirchen an der Pram;2001;2744;194;2938
AT31;41427;Vichtenstein;2001;629;132;761
AT31;41428;Waldkirchen am Wesen;2001;1282;25;1307
AT31;41429;Wernstein am Inn;2001;1557;95;1652
AT31;41430;Zell an der Pram;2001;1875;110;1985
AT31;41501;Adlwang;2001;1522;54;1576
AT31;41502;Aschach an der Steyr;2001;2102;27;2129
AT31;41503;Bad Hall;2001;4393;359;4752
AT31;41504;Dietach;2001;2312;120;2432
AT31;41505;Gaflenz;2001;1768;29;1797
AT31;41506;Garsten;2001;6231;225;6456
AT31;41507;Großraming;2001;2723;37;2760
AT31;41508;Laussa;2001;1345;20;1365
AT31;41509;Losenstein;2001;1701;32;1733
AT31;41510;Maria Neustift;2001;1649;3;1652
AT31;41511;Pfarrkirchen bei Bad Hall;2001;1963;81;2044
AT31;41512;Reichraming;2001;1844;39;1883
AT31;41513;Rohr im Kremstal;2001;1099;29;1128
AT31;41514;St. Ulrich bei Steyr;2001;2908;55;2963
AT31;41515;Schiedlberg;2001;1247;27;1274
AT31;41516;Sierning;2001;8118;398;8516
AT31;41517;Ternberg;2001;3299;42;3341
AT31;41518;Waldneukirchen;2001;2208;42;2250
AT31;41521;Wolfern;2001;2794;50;2844
AT31;41522;Weyer;2001;4545;171;4716
AT31;41601;Alberndorf in der Riedmark;2001;3545;39;3584
AT31;41602;Altenberg bei Linz;2001;4011;64;4075
AT31;41603;Bad Leonfelden;2001;3707;140;3847
AT31;41604;Eidenberg;2001;1781;30;1811
AT31;41605;Engerwitzdorf;2001;7401;115;7516
AT31;41606;Feldkirchen an der Donau;2001;4955;106;5061
AT31;41607;Gallneukirchen;2001;5680;235;5915
AT31;41608;Goldwörth;2001;856;14;870
AT31;41609;Gramastetten;2001;4434;91;4525
AT31;41610;Haibach im Mühlkreis;2001;772;11;783
AT31;41611;Hellmonsödt;2001;2022;60;2082
AT31;41612;Herzogsdorf;2001;2341;19;2360
AT31;41613;Kirchschlag bei Linz;2001;1879;24;1903
AT31;41614;Lichtenberg;2001;2363;26;2389
AT31;41615;Oberneukirchen;2001;2957;54;3011
AT31;41616;Ottenschlag im Mühlkreis;2001;477;2;479
AT31;41617;Ottensheim;2001;4164;148;4312
AT31;41618;Puchenau;2001;4557;117;4674
AT31;41619;Reichenau im Mühlkreis;2001;1137;23;1160
AT31;41620;Reichenthal;2001;1341;44;1385
AT31;41621;St. Gotthard im Mühlkreis;2001;1288;11;1299
AT31;41622;Schenkenfelden;2001;1486;19;1505
AT31;41623;Sonnberg im Mühlkreis;2001;790;4;794
AT31;41624;Steyregg;2001;4604;145;4749
AT31;41626;Walding;2001;3697;65;3762
AT31;41627;Zwettl an der Rodl;2001;1743;34;1777
AT31;41628;Vorderweißenbach;2001;2610;58;2668
AT31;41701;Ampflwang im Hausruckwald;2001;3442;169;3611
AT31;41702;Attersee am Attersee;2001;1433;62;1495
AT31;41703;Attnang-Puchheim;2001;7500;1257;8757
AT31;41704;Atzbach;2001;1122;31;1153
AT31;41705;Aurach am Hongar;2001;1472;112;1584
AT31;41706;Berg im Attergau;2001;947;40;987
AT31;41707;Desselbrunn;2001;1500;32;1532
AT31;41708;Fornach;2001;846;17;863
AT31;41709;Frankenburg am Hausruck;2001;4896;198;5094
AT31;41710;Frankenmarkt;2001;3186;321;3507
AT31;41711;Gampern;2001;2406;58;2464
AT31;41712;Innerschwand am Mondsee;2001;978;69;1047
AT31;41713;Lenzing;2001;4734;305;5039
AT31;41714;Manning;2001;811;18;829
AT31;41715;Mondsee;2001;2636;569;3205
AT31;41716;Neukirchen an der Vöckla;2001;2452;74;2526
AT31;41717;Niederthalheim;2001;1040;33;1073
AT31;41718;Nußdorf am Attersee;2001;1001;96;1097
AT31;41719;Oberhofen am Irrsee;2001;1252;80;1332
AT31;41720;Oberndorf bei Schwanenstadt;2001;1304;46;1350
AT31;41721;Oberwang;2001;1544;29;1573
AT31;41722;Ottnang am Hausruck;2001;3602;142;3744
AT31;41723;Pfaffing;2001;1347;24;1371
AT31;41724;Pilsbach;2001;614;15;629
AT31;41725;Pitzenberg;2001;492;2;494
AT31;41726;Pöndorf;2001;2187;47;2234
AT31;41727;Puchkirchen am Trattberg;2001;935;13;948
AT31;41728;Pühret;2001;566;7;573
AT31;41729;Redleiten;2001;461;4;465
AT31;41730;Redlham;2001;1232;77;1309
AT31;41731;Regau;2001;5132;359;5491
AT31;41732;Rüstorf;2001;1900;85;1985
AT31;41733;Rutzenham;2001;233;1;234
AT31;41734;St. Georgen im Attergau;2001;3467;550;4017
AT31;41735;St. Lorenz;2001;1868;140;2008
AT31;41736;Schlatt;2001;1235;97;1332
AT31;41737;Schörfling am Attersee;2001;2994;171;3165
AT31;41738;Schwanenstadt;2001;3557;574;4131
AT31;41739;Seewalchen am Attersee;2001;4517;232;4749
AT31;41740;Steinbach am Attersee;2001;767;142;909
AT31;41741;Straß im Attergau;2001;1396;84;1480
AT31;41742;Tiefgraben;2001;2879;188;3067
AT31;41743;Timelkam;2001;5398;398;5796
AT31;41744;Ungenach;2001;1319;29;1348
AT31;41745;Unterach am Attersee;2001;1335;156;1491
AT31;41746;Vöcklabruck;2001;10548;1149;11697
AT31;41747;Vöcklamarkt;2001;4308;455;4763
AT31;41748;Weißenkirchen im Attergau;2001;952;10;962
AT31;41749;Weyregg am Attersee;2001;1438;58;1496
AT31;41750;Wolfsegg am Hausruck;2001;1910;71;1981
AT31;41751;Zell am Moos;2001;1256;132;1388
AT31;41752;Zell am Pettenfirst;2001;1182;42;1224
AT31;41801;Aichkirchen;2001;486;14;500
AT31;41802;Bachmanning;2001;559;78;637
AT31;41803;Bad Wimsbach-Neydharting;2001;2249;111;2360
AT31;41804;Buchkirchen;2001;3497;133;3630
AT31;41805;Eberstalzell;2001;2110;80;2190
AT31;41806;Edt bei Lambach;2001;1933;148;2081
AT31;41807;Fischlham;2001;1233;27;1260
AT31;41808;Gunskirchen;2001;4998;289;5287
AT31;41809;Holzhausen;2001;623;16;639
AT31;41810;Krenglbach;2001;2577;67;2644
AT31;41811;Lambach;2001;2810;439;3249
AT31;41812;Marchtrenk;2001;10105;1169;11274
AT31;41813;Neukirchen bei Lambach;2001;819;10;829
AT31;41814;Offenhausen;2001;1426;118;1544
AT31;41815;Pennewang;2001;851;7;858
AT31;41816;Pichl bei Wels;2001;2573;146;2719
AT31;41817;Sattledt;2001;2062;173;2235
AT31;41818;Schleißheim;2001;901;37;938
AT31;41819;Sipbachzell;2001;1641;68;1709
AT31;41820;Stadl-Paura;2001;4291;575;4866
AT31;41821;Steinerkirchen an der Traun;2001;2076;69;2145
AT31;41822;Steinhaus;2001;1761;39;1800
AT31;41823;Thalheim bei Wels;2001;4478;480;4958
AT31;41824;Weißkirchen an der Traun;2001;2519;133;2652
AT31;40101;Linz;1991;185274;17770;203044
AT31;40201;Steyr;1991;36848;2489;39337
AT31;40301;Wels;1991;47933;4661;52594
AT31;40401;Altheim;1991;4565;116;4681
AT31;40402;Aspach;1991;2189;36;2225
AT31;40403;Auerbach;1991;488;10;498
AT31;40404;Braunau am Inn;1991;15150;1114;16264
AT31;40405;Burgkirchen;1991;2383;89;2472
AT31;40406;Eggelsberg;1991;1794;112;1906
AT31;40407;Feldkirchen bei Mattighofen;1991;1690;53;1743
AT31;40408;Franking;1991;693;264;957
AT31;40409;Geretsberg;1991;964;120;1084
AT31;40410;Gilgenberg am Weilhart;1991;1102;47;1149
AT31;40411;Haigermoos;1991;477;5;482
AT31;40412;Handenberg;1991;1290;28;1318
AT31;40413;Helpfau-Uttendorf;1991;2860;249;3109
AT31;40414;Hochburg-Ach;1991;2848;257;3105
AT31;40415;Höhnhart;1991;1406;4;1410
AT31;40416;Jeging;1991;526;71;597
AT31;40417;Kirchberg bei Mattighofen;1991;926;24;950
AT31;40418;Lengau;1991;3966;191;4157
AT31;40419;Lochen am See;1991;2004;62;2066
AT31;40420;Maria Schmolln;1991;1236;19;1255
AT31;40421;Mattighofen;1991;4164;546;4710
AT31;40422;Mauerkirchen;1991;2060;312;2372
AT31;40423;Mining;1991;1081;24;1105
AT31;40424;Moosbach;1991;774;48;822
AT31;40425;Moosdorf;1991;1241;47;1288
AT31;40426;Munderfing;1991;2313;142;2455
AT31;40427;Neukirchen an der Enknach;1991;2024;83;2107
AT31;40428;Ostermiething;1991;2380;136;2516
AT31;40429;Palting;1991;773;12;785
AT31;40430;Perwang am Grabensee;1991;621;19;640
AT31;40431;Pfaffstätt;1991;785;108;893
AT31;40432;Pischelsdorf am Engelbach;1991;1489;24;1513
AT31;40433;Polling im Innkreis;1991;891;14;905
AT31;40434;Roßbach;1991;876;16;892
AT31;40435;St. Georgen am Fillmannsbach;1991;322;79;401
AT31;40436;St. Johann am Walde;1991;2020;17;2037
AT31;40437;St. Pantaleon;1991;2821;287;3108
AT31;40438;St. Peter am Hart;1991;1952;117;2069
AT31;40439;St. Radegund;1991;538;22;560
AT31;40440;St. Veit im Innkreis;1991;402;1;403
AT31;40441;Schalchen;1991;3128;145;3273
AT31;40442;Schwand im Innkreis;1991;825;3;828
AT31;40443;Tarsdorf;1991;1749;44;1793
AT31;40444;Treubach;1991;692;6;698
AT31;40445;Überackern;1991;526;24;550
AT31;40446;Weng im Innkreis;1991;1286;26;1312
AT31;40501;Alkoven;1991;4638;138;4776
AT31;40502;Aschach an der Donau;1991;2079;61;2140
AT31;40503;Eferding;1991;3023;129;3152
AT31;40504;Fraham;1991;1794;145;1939
AT31;40505;Haibach ob der Donau;1991;1210;22;1232
AT31;40506;Hartkirchen;1991;3911;98;4009
AT31;40507;Hinzenbach;1991;1614;35;1649
AT31;40508;Prambachkirchen;1991;2529;96;2625
AT31;40509;Pupping;1991;1794;63;1857
AT31;40510;St. Marienkirchen an der Polsenz;1991;1922;63;1985
AT31;40511;Scharten;1991;1721;59;1780
AT31;40512;Stroheim;1991;1570;12;1582
AT31;40601;Freistadt;1991;6755;162;6917
AT31;40602;Grünbach;1991;1610;31;1641
AT31;40603;Gutau;1991;2499;49;2548
AT31;40604;Hagenberg im Mühlkreis;1991;2120;17;2137
AT31;40605;Hirschbach im Mühlkreis;1991;1148;14;1162
AT31;40606;Kaltenberg;1991;666;0;666
AT31;40607;Kefermarkt;1991;1885;65;1950
AT31;40608;Königswiesen;1991;3077;13;3090
AT31;40609;Lasberg;1991;2605;112;2717
AT31;40610;Leopoldschlag;1991;1034;81;1115
AT31;40611;Liebenau;1991;1943;14;1957
AT31;40612;Neumarkt im Mühlkreis;1991;2723;20;2743
AT31;40613;Pierbach;1991;969;20;989
AT31;40614;Pregarten;1991;4143;56;4199
AT31;40615;Rainbach im Mühlkreis;1991;2768;113;2881
AT31;40616;Sandl;1991;1505;53;1558
AT31;40617;St. Leonhard bei Freistadt;1991;1492;10;1502
AT31;40618;St. Oswald bei Freistadt;1991;2454;64;2518
AT31;40619;Schönau im Mühlkreis;1991;1792;31;1823
AT31;40620;Tragwein;1991;2807;47;2854
AT31;40621;Unterweißenbach;1991;2453;12;2465
AT31;40622;Unterweitersdorf;1991;1406;9;1415
AT31;40623;Waldburg;1991;1318;10;1328
AT31;40624;Wartberg ob der Aist;1991;3171;19;3190
AT31;40625;Weitersfelden;1991;1162;39;1201
AT31;40626;Windhaag bei Freistadt;1991;1739;109;1848
AT31;40627;Bad Zell;1991;2649;38;2687
AT31;40701;Altmünster;1991;8729;338;9067
AT31;40702;Bad Goisern am Hallstättersee;1991;6669;280;6949
AT31;40703;Bad Ischl;1991;12920;967;13887
AT31;40704;Ebensee am Traunsee;1991;8456;278;8734
AT31;40705;Gmunden;1991;12049;1084;13133
AT31;40706;Gosau;1991;1896;46;1942
AT31;40707;Grünau im Almtal;1991;2010;127;2137
AT31;40708;Gschwandt;1991;2359;66;2425
AT31;40709;Hallstatt;1991;1029;124;1153
AT31;40710;Kirchham;1991;1802;112;1914
AT31;40711;Laakirchen;1991;7506;462;7968
AT31;40712;Obertraun;1991;776;35;811
AT31;40713;Ohlsdorf;1991;3973;206;4179
AT31;40714;Pinsdorf;1991;3025;151;3176
AT31;40715;Roitham am Traunfall;1991;1878;46;1924
AT31;40716;St. Konrad;1991;910;13;923
AT31;40717;St. Wolfgang im Salzkammergut;1991;2517;191;2708
AT31;40718;Traunkirchen;1991;1556;186;1742
AT31;40719;Scharnstein;1991;4081;228;4309
AT31;40720;Vorchdorf;1991;6335;533;6868
AT31;40801;Aistersheim;1991;676;58;734
AT31;40802;Bad Schallerbach;1991;2914;196;3110
AT31;40804;Eschenau im Hausruckkreis;1991;1183;12;1195
AT31;40805;Gallspach;1991;2076;386;2462
AT31;40806;Gaspoltshofen;1991;3405;94;3499
AT31;40807;Geboltskirchen;1991;1362;60;1422
AT31;40808;Grieskirchen;1991;4624;336;4960
AT31;40809;Haag am Hausruck;1991;1923;69;1992
AT31;40810;Heiligenberg;1991;697;2;699
AT31;40811;Hofkirchen an der Trattnach;1991;1350;128;1478
AT31;40812;Kallham;1991;2548;74;2622
AT31;40813;Kematen am Innbach;1991;1011;61;1072
AT31;40814;Meggenhofen;1991;1189;38;1227
AT31;40815;Michaelnbach;1991;1167;10;1177
AT31;40816;Natternbach;1991;2266;34;2300
AT31;40817;Neukirchen am Walde;1991;1551;29;1580
AT31;40818;Neumarkt im Hausruckkreis;1991;1416;92;1508
AT31;40820;Pötting;1991;504;0;504
AT31;40821;Pollham;1991;860;6;866
AT31;40822;Pram;1991;1715;66;1781
AT31;40823;Rottenbach;1991;857;12;869
AT31;40824;St. Agatha;1991;2071;8;2079
AT31;40825;St. Georgen bei Grieskirchen;1991;844;9;853
AT31;40826;St. Thomas;1991;410;7;417
AT31;40827;Schlüßlberg;1991;2500;41;2541
AT31;40828;Steegen;1991;1243;3;1246
AT31;40829;Taufkirchen an der Trattnach;1991;1867;55;1922
AT31;40830;Tollet;1991;768;20;788
AT31;40831;Waizenkirchen;1991;3552;50;3602
AT31;40832;Wallern an der Trattnach;1991;2554;64;2618
AT31;40833;Weibern;1991;1490;56;1546
AT31;40834;Wendling;1991;727;38;765
AT31;40835;Peuerbach;1991;4252;58;4310
AT31;40901;Edlbach;1991;641;45;686
AT31;40902;Grünburg;1991;3413;285;3698
AT31;40903;Hinterstoder;1991;984;51;1035
AT31;40904;Inzersdorf im Kremstal;1991;1717;66;1783
AT31;40905;Kirchdorf an der Krems;1991;3646;92;3738
AT31;40906;Klaus an der Pyhrnbahn;1991;1034;65;1099
AT31;40907;Kremsmünster;1991;5486;477;5963
AT31;40908;Micheldorf in Oberösterreich;1991;4704;166;4870
AT31;40909;Molln;1991;3446;307;3753
AT31;40910;Nußbach;1991;2007;27;2034
AT31;40911;Oberschlierbach;1991;435;19;454
AT31;40912;Pettenbach;1991;4119;178;4297
AT31;40913;Ried im Traunkreis;1991;2147;122;2269
AT31;40914;Rosenau am Hengstpaß;1991;752;38;790
AT31;40915;Roßleithen;1991;1725;45;1770
AT31;40916;St. Pankraz;1991;361;11;372
AT31;40917;Schlierbach;1991;2428;87;2515
AT31;40918;Spital am Pyhrn;1991;2152;45;2197
AT31;40919;Steinbach am Ziehberg;1991;825;9;834
AT31;40920;Steinbach an der Steyr;1991;1924;72;1996
AT31;40921;Vorderstoder;1991;726;13;739
AT31;40922;Wartberg an der Krems;1991;2535;77;2612
AT31;40923;Windischgarsten;1991;2023;81;2104
AT31;41001;Allhaming;1991;784;56;840
AT31;41002;Ansfelden;1991;13182;1454;14636
AT31;41003;Asten;1991;4851;296;5147
AT31;41004;Eggendorf im Traunkreis;1991;546;10;556
AT31;41005;Enns;1991;9343;847;10190
AT31;41006;Hargelsberg;1991;840;7;847
AT31;41007;Hörsching;1991;4763;338;5101
AT31;41008;Hofkirchen im Traunkreis;1991;1114;19;1133
AT31;41009;Kematen an der Krems;1991;1791;92;1883
AT31;41010;Kirchberg-Thening;1991;1936;19;1955
AT31;41011;Kronstorf;1991;2399;19;2418
AT31;41012;Leonding;1991;20033;1176;21209
AT31;41013;St. Florian;1991;4950;166;5116
AT31;41014;Neuhofen an der Krems;1991;4485;180;4665
AT31;41015;Niederneukirchen;1991;1535;27;1562
AT31;41016;Oftering;1991;1597;31;1628
AT31;41017;Pasching;1991;5715;347;6062
AT31;41018;Piberbach;1991;1473;38;1511
AT31;41019;Pucking;1991;2536;77;2613
AT31;41020;St. Marien;1991;3283;77;3360
AT31;41021;Traun;1991;19535;2725;22260
AT31;41022;Wilhering;1991;4485;164;4649
AT31;41101;Allerheiligen im Mühlkreis;1991;1080;23;1103
AT31;41102;Arbing;1991;1216;53;1269
AT31;41103;Baumgartenberg;1991;1355;69;1424
AT31;41104;Dimbach;1991;1098;20;1118
AT31;41105;Grein;1991;2818;92;2910
AT31;41106;Katsdorf;1991;2267;23;2290
AT31;41107;Klam;1991;716;20;736
AT31;41108;Bad Kreuzen;1991;2080;197;2277
AT31;41109;Langenstein;1991;2285;128;2413
AT31;41110;Luftenberg an der Donau;1991;3254;29;3283
AT31;41111;Mauthausen;1991;4113;290;4403
AT31;41112;Mitterkirchen im Machland;1991;1730;45;1775
AT31;41113;Münzbach;1991;1476;35;1511
AT31;41114;Naarn im Machlande;1991;3013;64;3077
AT31;41115;Pabneukirchen;1991;1727;38;1765
AT31;41116;Perg;1991;5733;225;5958
AT31;41117;Rechberg;1991;730;51;781
AT31;41118;Ried in der Riedmark;1991;3360;78;3438
AT31;41119;St. Georgen am Walde;1991;2210;12;2222
AT31;41120;St. Georgen an der Gusen;1991;3193;43;3236
AT31;41121;St. Nikola an der Donau;1991;797;122;919
AT31;41122;St. Thomas am Blasenstein;1991;887;24;911
AT31;41123;Saxen;1991;1539;67;1606
AT31;41124;Schwertberg;1991;4350;182;4532
AT31;41125;Waldhausen im Strudengau;1991;2746;145;2891
AT31;41126;Windhaag bei Perg;1991;1177;31;1208
AT31;41201;Andrichsfurt;1991;702;8;710
AT31;41202;Antiesenhofen;1991;936;54;990
AT31;41203;Aurolzmünster;1991;2506;85;2591
AT31;41204;Eberschwang;1991;3250;81;3331
AT31;41205;Eitzing;1991;626;4;630
AT31;41206;Geiersberg;1991;485;0;485
AT31;41207;Geinberg;1991;1226;45;1271
AT31;41208;Gurten;1991;1113;30;1143
AT31;41209;Hohenzell;1991;1857;13;1870
AT31;41210;Kirchdorf am Inn;1991;591;29;620
AT31;41211;Kirchheim im Innkreis;1991;614;5;619
AT31;41212;Lambrechten;1991;1261;13;1274
AT31;41213;Lohnsburg am Kobernaußerwald;1991;2277;20;2297
AT31;41214;Mehrnbach;1991;2053;26;2079
AT31;41215;Mettmach;1991;2561;12;2573
AT31;41216;Mörschwang;1991;314;0;314
AT31;41217;Mühlheim am Inn;1991;659;10;669
AT31;41218;Neuhofen im Innkreis;1991;1743;43;1786
AT31;41219;Obernberg am Inn;1991;1545;214;1759
AT31;41220;Ort im Innkreis;1991;1163;39;1202
AT31;41221;Pattigham;1991;786;3;789
AT31;41222;Peterskirchen;1991;724;13;737
AT31;41223;Pramet;1991;950;42;992
AT31;41224;Reichersberg;1991;1324;55;1379
AT31;41225;Ried im Innkreis;1991;10530;730;11260
AT31;41226;St. Georgen bei Obernberg am Inn;1991;562;16;578
AT31;41227;St. Marienkirchen am Hausruck;1991;637;18;655
AT31;41228;St. Martin im Innkreis;1991;1507;88;1595
AT31;41229;Schildorn;1991;882;2;884
AT31;41230;Senftenbach;1991;652;3;655
AT31;41231;Taiskirchen im Innkreis;1991;2351;5;2356
AT31;41232;Tumeltsham;1991;1123;22;1145
AT31;41233;Utzenaich;1991;1349;36;1385
AT31;41234;Waldzell;1991;1949;20;1969
AT31;41235;Weilbach;1991;599;4;603
AT31;41236;Wippenham;1991;519;8;527
AT31;41304;Altenfelden;1991;2061;42;2103
AT31;41305;Arnreit;1991;1051;2;1053
AT31;41306;Atzesberg;1991;492;44;536
AT31;41307;Auberg;1991;545;73;618
AT31;41309;Haslach an der Mühl;1991;2505;24;2529
AT31;41311;Hörbich;1991;424;4;428
AT31;41312;Hofkirchen im Mühlkreis;1991;1392;35;1427
AT31;41313;Julbach;1991;1604;44;1648
AT31;41314;Kirchberg ob der Donau;1991;1074;34;1108
AT31;41315;Klaffer am Hochficht;1991;1275;36;1311
AT31;41316;Kleinzell im Mühlkreis;1991;1360;27;1387
AT31;41317;Kollerschlag;1991;1391;24;1415
AT31;41318;Lembach im Mühlkreis;1991;1395;137;1532
AT31;41319;Lichtenau im Mühlkreis;1991;576;1;577
AT31;41320;Nebelberg;1991;618;14;632
AT31;41321;Neufelden;1991;1159;77;1236
AT31;41322;Niederkappel;1991;1070;25;1095
AT31;41323;Niederwaldkirchen;1991;1709;45;1754
AT31;41324;Oberkappel;1991;706;73;779
AT31;41325;Oepping;1991;1442;15;1457
AT31;41326;Peilstein im Mühlviertel;1991;1639;33;1672
AT31;41327;Pfarrkirchen im Mühlkreis;1991;1486;26;1512
AT31;41328;Putzleinsdorf;1991;1536;76;1612
AT31;41329;Neustift im Mühlkreis;1991;1444;29;1473
AT31;41331;St. Johann am Wimberg;1991;941;2;943
AT31;41332;St. Martin im Mühlkreis;1991;3055;184;3239
AT31;41333;St. Oswald bei Haslach;1991;568;2;570
AT31;41334;St. Peter am Wimberg;1991;1602;5;1607
AT31;41336;St. Ulrich im Mühlkreis;1991;563;1;564
AT31;41337;St. Veit im Mühlkreis;1991;1064;8;1072
AT31;41338;Sarleinsbach;1991;2268;56;2324
AT31;41341;Schwarzenberg am Böhmerwald;1991;675;61;736
AT31;41342;Ulrichsberg;1991;3014;97;3111
AT31;41343;Aigen-Schlägl;1991;3129;123;3252
AT31;41344;Rohrbach-Berg;1991;4696;101;4797
AT31;41345;Helfenberg;1991;1548;61;1609
AT31;41346;St. Stefan-Afiesl;1991;1257;15;1272
AT31;41401;Altschwendt;1991;669;18;687
AT31;41402;Andorf;1991;4384;88;4472
AT31;41403;Brunnenthal;1991;1620;60;1680
AT31;41404;Diersbach;1991;1627;58;1685
AT31;41405;Dorf an der Pram;1991;975;7;982
AT31;41406;Eggerding;1991;1270;36;1306
AT31;41407;Engelhartszell;1991;1093;67;1160
AT31;41408;Enzenkirchen;1991;1676;72;1748
AT31;41409;Esternberg;1991;2573;121;2694
AT31;41410;Freinberg;1991;1275;306;1581
AT31;41411;Kopfing im Innkreis;1991;2028;46;2074
AT31;41412;Mayrhof;1991;238;0;238
AT31;41413;Münzkirchen;1991;2474;48;2522
AT31;41414;Raab;1991;2139;69;2208
AT31;41415;Rainbach im Innkreis;1991;1435;22;1457
AT31;41416;Riedau;1991;1846;51;1897
AT31;41417;St. Aegidi;1991;1565;27;1592
AT31;41418;St. Florian am Inn;1991;2591;126;2717
AT31;41419;St. Marienkirchen bei Schärding;1991;1794;26;1820
AT31;41420;St. Roman;1991;1728;38;1766
AT31;41421;St. Willibald;1991;1088;42;1130
AT31;41422;Schärding;1991;5247;199;5446
AT31;41423;Schardenberg;1991;2151;462;2613
AT31;41424;Sigharting;1991;763;98;861
AT31;41425;Suben;1991;1235;52;1287
AT31;41426;Taufkirchen an der Pram;1991;2823;134;2957
AT31;41427;Vichtenstein;1991;623;103;726
AT31;41428;Waldkirchen am Wesen;1991;1331;23;1354
AT31;41429;Wernstein am Inn;1991;1581;78;1659
AT31;41430;Zell an der Pram;1991;1942;73;2015
AT31;41501;Adlwang;1991;1341;38;1379
AT31;41502;Aschach an der Steyr;1991;1801;16;1817
AT31;41503;Bad Hall;1991;4046;204;4250
AT31;41504;Dietach;1991;2008;105;2113
AT31;41505;Gaflenz;1991;1662;15;1677
AT31;41506;Garsten;1991;5831;240;6071
AT31;41507;Großraming;1991;2790;27;2817
AT31;41508;Laussa;1991;1299;18;1317
AT31;41509;Losenstein;1991;1720;27;1747
AT31;41510;Maria Neustift;1991;1604;4;1608
AT31;41511;Pfarrkirchen bei Bad Hall;1991;1911;71;1982
AT31;41512;Reichraming;1991;1894;42;1936
AT31;41513;Rohr im Kremstal;1991;992;30;1022
AT31;41514;St. Ulrich bei Steyr;1991;2831;42;2873
AT31;41515;Schiedlberg;1991;1221;23;1244
AT31;41516;Sierning;1991;7759;229;7988
AT31;41517;Ternberg;1991;3184;58;3242
AT31;41518;Waldneukirchen;1991;2068;62;2130
AT31;41521;Wolfern;1991;2628;28;2656
AT31;41522;Weyer;1991;4611;110;4721
AT31;41601;Alberndorf in der Riedmark;1991;3134;25;3159
AT31;41602;Altenberg bei Linz;1991;3670;62;3732
AT31;41603;Bad Leonfelden;1991;3362;57;3419
AT31;41604;Eidenberg;1991;1616;30;1646
AT31;41605;Engerwitzdorf;1991;5919;100;6019
AT31;41606;Feldkirchen an der Donau;1991;4471;63;4534
AT31;41607;Gallneukirchen;1991;5029;85;5114
AT31;41608;Goldwörth;1991;691;7;698
AT31;41609;Gramastetten;1991;4124;77;4201
AT31;41610;Haibach im Mühlkreis;1991;664;4;668
AT31;41611;Hellmonsödt;1991;1751;53;1804
AT31;41612;Herzogsdorf;1991;2120;11;2131
AT31;41613;Kirchschlag bei Linz;1991;1656;27;1683
AT31;41614;Lichtenberg;1991;2125;22;2147
AT31;41615;Oberneukirchen;1991;2893;53;2946
AT31;41616;Ottenschlag im Mühlkreis;1991;476;1;477
AT31;41617;Ottensheim;1991;3676;120;3796
AT31;41618;Puchenau;1991;4637;81;4718
AT31;41619;Reichenau im Mühlkreis;1991;893;11;904
AT31;41620;Reichenthal;1991;1245;19;1264
AT31;41621;St. Gotthard im Mühlkreis;1991;1106;19;1125
AT31;41622;Schenkenfelden;1991;1329;14;1343
AT31;41623;Sonnberg im Mühlkreis;1991;715;1;716
AT31;41624;Steyregg;1991;4413;123;4536
AT31;41626;Walding;1991;3198;47;3245
AT31;41627;Zwettl an der Rodl;1991;1594;37;1631
AT31;41628;Vorderweißenbach;1991;2563;55;2618
AT31;41701;Ampflwang im Hausruckwald;1991;3760;54;3814
AT31;41702;Attersee am Attersee;1991;1408;73;1481
AT31;41703;Attnang-Puchheim;1991;7513;626;8139
AT31;41704;Atzbach;1991;1048;12;1060
AT31;41705;Aurach am Hongar;1991;1316;52;1368
AT31;41706;Berg im Attergau;1991;946;160;1106
AT31;41707;Desselbrunn;1991;1554;27;1581
AT31;41708;Fornach;1991;779;7;786
AT31;41709;Frankenburg am Hausruck;1991;4858;155;5013
AT31;41710;Frankenmarkt;1991;3102;131;3233
AT31;41711;Gampern;1991;2177;35;2212
AT31;41712;Innerschwand am Mondsee;1991;841;62;903
AT31;41713;Lenzing;1991;4879;184;5063
AT31;41714;Manning;1991;731;32;763
AT31;41715;Mondsee;1991;2341;259;2600
AT31;41716;Neukirchen an der Vöckla;1991;2383;72;2455
AT31;41717;Niederthalheim;1991;1021;47;1068
AT31;41718;Nußdorf am Attersee;1991;970;149;1119
AT31;41719;Oberhofen am Irrsee;1991;1103;42;1145
AT31;41720;Oberndorf bei Schwanenstadt;1991;1260;17;1277
AT31;41721;Oberwang;1991;1423;20;1443
AT31;41722;Ottnang am Hausruck;1991;3663;80;3743
AT31;41723;Pfaffing;1991;1233;33;1266
AT31;41724;Pilsbach;1991;539;15;554
AT31;41725;Pitzenberg;1991;451;16;467
AT31;41726;Pöndorf;1991;2026;99;2125
AT31;41727;Puchkirchen am Trattberg;1991;852;16;868
AT31;41728;Pühret;1991;542;8;550
AT31;41729;Redleiten;1991;387;7;394
AT31;41730;Redlham;1991;1148;82;1230
AT31;41731;Regau;1991;5062;303;5365
AT31;41732;Rüstorf;1991;1823;77;1900
AT31;41733;Rutzenham;1991;239;0;239
AT31;41734;St. Georgen im Attergau;1991;3171;481;3652
AT31;41735;St. Lorenz;1991;1712;110;1822
AT31;41736;Schlatt;1991;1170;58;1228
AT31;41737;Schörfling am Attersee;1991;2912;147;3059
AT31;41738;Schwanenstadt;1991;3511;276;3787
AT31;41739;Seewalchen am Attersee;1991;4010;243;4253
AT31;41740;Steinbach am Attersee;1991;862;140;1002
AT31;41741;Straß im Attergau;1991;1314;242;1556
AT31;41742;Tiefgraben;1991;2485;237;2722
AT31;41743;Timelkam;1991;5369;354;5723
AT31;41744;Ungenach;1991;1223;14;1237
AT31;41745;Unterach am Attersee;1991;1263;51;1314
AT31;41746;Vöcklabruck;1991;10674;565;11239
AT31;41747;Vöcklamarkt;1991;4200;313;4513
AT31;41748;Weißenkirchen im Attergau;1991;896;25;921
AT31;41749;Weyregg am Attersee;1991;1484;138;1622
AT31;41750;Wolfsegg am Hausruck;1991;1939;60;1999
AT31;41751;Zell am Moos;1991;1100;90;1190
AT31;41752;Zell am Pettenfirst;1991;1077;29;1106
AT31;41801;Aichkirchen;1991;478;2;480
AT31;41802;Bachmanning;1991;525;46;571
AT31;41803;Bad Wimsbach-Neydharting;1991;2187;113;2300
AT31;41804;Buchkirchen;1991;3075;112;3187
AT31;41805;Eberstalzell;1991;1909;46;1955
AT31;41806;Edt bei Lambach;1991;1689;109;1798
AT31;41807;Fischlham;1991;1049;39;1088
AT31;41808;Gunskirchen;1991;4751;210;4961
AT31;41809;Holzhausen;1991;548;49;597
AT31;41810;Krenglbach;1991;2296;88;2384
AT31;41811;Lambach;1991;3073;359;3432
AT31;41812;Marchtrenk;1991;9549;820;10369
AT31;41813;Neukirchen bei Lambach;1991;778;21;799
AT31;41814;Offenhausen;1991;1278;62;1340
AT31;41815;Pennewang;1991;798;15;813
AT31;41816;Pichl bei Wels;1991;2308;195;2503
AT31;41817;Sattledt;1991;2025;151;2176
AT31;41818;Schleißheim;1991;783;62;845
AT31;41819;Sipbachzell;1991;1444;36;1480
AT31;41820;Stadl-Paura;1991;4352;486;4838
AT31;41821;Steinerkirchen an der Traun;1991;2001;67;2068
AT31;41822;Steinhaus;1991;1691;43;1734
AT31;41823;Thalheim bei Wels;1991;4102;423;4525
AT31;41824;Weißkirchen an der Traun;1991;2020;69;2089
AT31;40101;Linz;1981;192271;7639;199910
AT31;40201;Steyr;1981;37744;1198;38942
AT31;40301;Wels;1981;48507;2553;51060
AT31;40401;Altheim;1981;4610;74;4684
AT31;40402;Aspach;1981;2191;10;2201
AT31;40403;Auerbach;1981;459;1;460
AT31;40404;Braunau am Inn;1981;15703;615;16318
AT31;40405;Burgkirchen;1981;2333;36;2369
AT31;40406;Eggelsberg;1981;1691;50;1741
AT31;40407;Feldkirchen bei Mattighofen;1981;1620;17;1637
AT31;40408;Franking;1981;646;14;660
AT31;40409;Geretsberg;1981;912;33;945
AT31;40410;Gilgenberg am Weilhart;1981;1054;17;1071
AT31;40411;Haigermoos;1981;461;6;467
AT31;40412;Handenberg;1981;1288;5;1293
AT31;40413;Helpfau-Uttendorf;1981;2662;76;2738
AT31;40414;Hochburg-Ach;1981;2841;171;3012
AT31;40415;Höhnhart;1981;1436;3;1439
AT31;40416;Jeging;1981;489;13;502
AT31;40417;Kirchberg bei Mattighofen;1981;863;3;866
AT31;40418;Lengau;1981;3772;68;3840
AT31;40419;Lochen am See;1981;1858;8;1866
AT31;40420;Maria Schmolln;1981;1185;13;1198
AT31;40421;Mattighofen;1981;4260;300;4560
AT31;40422;Mauerkirchen;1981;2042;64;2106
AT31;40423;Mining;1981;1003;20;1023
AT31;40424;Moosbach;1981;751;6;757
AT31;40425;Moosdorf;1981;1141;14;1155
AT31;40426;Munderfing;1981;2304;27;2331
AT31;40427;Neukirchen an der Enknach;1981;1885;11;1896
AT31;40428;Ostermiething;1981;2132;65;2197
AT31;40429;Palting;1981;737;8;745
AT31;40430;Perwang am Grabensee;1981;605;2;607
AT31;40431;Pfaffstätt;1981;742;22;764
AT31;40432;Pischelsdorf am Engelbach;1981;1523;11;1534
AT31;40433;Polling im Innkreis;1981;951;0;951
AT31;40434;Roßbach;1981;846;4;850
AT31;40435;St. Georgen am Fillmannsbach;1981;321;15;336
AT31;40436;St. Johann am Walde;1981;1953;2;1955
AT31;40437;St. Pantaleon;1981;2823;178;3001
AT31;40438;St. Peter am Hart;1981;1768;44;1812
AT31;40439;St. Radegund;1981;511;13;524
AT31;40440;St. Veit im Innkreis;1981;355;0;355
AT31;40441;Schalchen;1981;3102;157;3259
AT31;40442;Schwand im Innkreis;1981;838;3;841
AT31;40443;Tarsdorf;1981;1639;13;1652
AT31;40444;Treubach;1981;662;0;662
AT31;40445;Überackern;1981;509;18;527
AT31;40446;Weng im Innkreis;1981;1346;8;1354
AT31;40501;Alkoven;1981;4300;64;4364
AT31;40502;Aschach an der Donau;1981;2140;22;2162
AT31;40503;Eferding;1981;3081;30;3111
AT31;40504;Fraham;1981;1788;17;1805
AT31;40505;Haibach ob der Donau;1981;1210;0;1210
AT31;40506;Hartkirchen;1981;3735;22;3757
AT31;40507;Hinzenbach;1981;1596;20;1616
AT31;40508;Prambachkirchen;1981;2489;13;2502
AT31;40509;Pupping;1981;1752;19;1771
AT31;40510;St. Marienkirchen an der Polsenz;1981;1739;15;1754
AT31;40511;Scharten;1981;1570;20;1590
AT31;40512;Stroheim;1981;1517;4;1521
AT31;40601;Freistadt;1981;6217;34;6251
AT31;40602;Grünbach;1981;1567;3;1570
AT31;40603;Gutau;1981;2371;8;2379
AT31;40604;Hagenberg im Mühlkreis;1981;1757;7;1764
AT31;40605;Hirschbach im Mühlkreis;1981;1151;1;1152
AT31;40606;Kaltenberg;1981;676;18;694
AT31;40607;Kefermarkt;1981;1734;4;1738
AT31;40608;Königswiesen;1981;3057;0;3057
AT31;40609;Lasberg;1981;2486;13;2499
AT31;40610;Leopoldschlag;1981;1067;43;1110
AT31;40611;Liebenau;1981;2099;9;2108
AT31;40612;Neumarkt im Mühlkreis;1981;2531;8;2539
AT31;40613;Pierbach;1981;953;0;953
AT31;40614;Pregarten;1981;3789;20;3809
AT31;40615;Rainbach im Mühlkreis;1981;2762;1;2763
AT31;40616;Sandl;1981;1645;5;1650
AT31;40617;St. Leonhard bei Freistadt;1981;1474;0;1474
AT31;40618;St. Oswald bei Freistadt;1981;2292;4;2296
AT31;40619;Schönau im Mühlkreis;1981;1736;0;1736
AT31;40620;Tragwein;1981;2763;1;2764
AT31;40621;Unterweißenbach;1981;2456;45;2501
AT31;40622;Unterweitersdorf;1981;1169;1;1170
AT31;40623;Waldburg;1981;1238;12;1250
AT31;40624;Wartberg ob der Aist;1981;2763;0;2763
AT31;40625;Weitersfelden;1981;1249;35;1284
AT31;40626;Windhaag bei Freistadt;1981;1765;108;1873
AT31;40627;Bad Zell;1981;2619;4;2623
AT31;40701;Altmünster;1981;8293;263;8556
AT31;40702;Bad Goisern am Hallstättersee;1981;6358;98;6456
AT31;40703;Bad Ischl;1981;12423;547;12970
AT31;40704;Ebensee am Traunsee;1981;8873;110;8983
AT31;40705;Gmunden;1981;12141;512;12653
AT31;40706;Gosau;1981;1840;11;1851
AT31;40707;Grünau im Almtal;1981;2058;52;2110
AT31;40708;Gschwandt;1981;2124;28;2152
AT31;40709;Hallstatt;1981;1107;19;1126
AT31;40710;Kirchham;1981;1543;9;1552
AT31;40711;Laakirchen;1981;7462;204;7666
AT31;40712;Obertraun;1981;741;17;758
AT31;40713;Ohlsdorf;1981;3710;58;3768
AT31;40714;Pinsdorf;1981;2743;63;2806
AT31;40715;Roitham am Traunfall;1981;1829;1;1830
AT31;40716;St. Konrad;1981;864;5;869
AT31;40717;St. Wolfgang im Salzkammergut;1981;2396;73;2469
AT31;40718;Traunkirchen;1981;1569;34;1603
AT31;40719;Scharnstein;1981;3995;66;4061
AT31;40720;Vorchdorf;1981;6021;242;6263
AT31;40801;Aistersheim;1981;680;0;680
AT31;40802;Bad Schallerbach;1981;2832;58;2890
AT31;40804;Eschenau im Hausruckkreis;1981;1115;7;1122
AT31;40805;Gallspach;1981;1960;54;2014
AT31;40806;Gaspoltshofen;1981;3246;46;3292
AT31;40807;Geboltskirchen;1981;1401;14;1415
AT31;40808;Grieskirchen;1981;4624;190;4814
AT31;40809;Haag am Hausruck;1981;1983;31;2014
AT31;40810;Heiligenberg;1981;663;3;666
AT31;40811;Hofkirchen an der Trattnach;1981;1347;15;1362
AT31;40812;Kallham;1981;2518;31;2549
AT31;40813;Kematen am Innbach;1981;1080;5;1085
AT31;40814;Meggenhofen;1981;1193;7;1200
AT31;40815;Michaelnbach;1981;1226;0;1226
AT31;40816;Natternbach;1981;2124;13;2137
AT31;40817;Neukirchen am Walde;1981;1635;8;1643
AT31;40818;Neumarkt im Hausruckkreis;1981;1521;30;1551
AT31;40820;Pötting;1981;506;0;506
AT31;40821;Pollham;1981;829;1;830
AT31;40822;Pram;1981;1699;3;1702
AT31;40823;Rottenbach;1981;862;4;866
AT31;40824;St. Agatha;1981;2040;10;2050
AT31;40825;St. Georgen bei Grieskirchen;1981;788;0;788
AT31;40826;St. Thomas;1981;374;0;374
AT31;40827;Schlüßlberg;1981;2419;13;2432
AT31;40828;Steegen;1981;1047;1;1048
AT31;40829;Taufkirchen an der Trattnach;1981;1809;8;1817
AT31;40830;Tollet;1981;634;1;635
AT31;40831;Waizenkirchen;1981;3557;9;3566
AT31;40832;Wallern an der Trattnach;1981;2264;46;2310
AT31;40833;Weibern;1981;1515;55;1570
AT31;40834;Wendling;1981;695;1;696
AT31;40835;Peuerbach;1981;4231;11;4242
AT31;40901;Edlbach;1981;570;15;585
AT31;40902;Grünburg;1981;3458;163;3621
AT31;40903;Hinterstoder;1981;986;67;1053
AT31;40904;Inzersdorf im Kremstal;1981;1681;18;1699
AT31;40905;Kirchdorf an der Krems;1981;3635;67;3702
AT31;40906;Klaus an der Pyhrnbahn;1981;1144;43;1187
AT31;40907;Kremsmünster;1981;5615;196;5811
AT31;40908;Micheldorf in Oberösterreich;1981;4473;97;4570
AT31;40909;Molln;1981;3383;160;3543
AT31;40910;Nußbach;1981;1839;7;1846
AT31;40911;Oberschlierbach;1981;389;6;395
AT31;40912;Pettenbach;1981;3956;87;4043
AT31;40913;Ried im Traunkreis;1981;2062;44;2106
AT31;40914;Rosenau am Hengstpaß;1981;864;41;905
AT31;40915;Roßleithen;1981;1718;35;1753
AT31;40916;St. Pankraz;1981;386;1;387
AT31;40917;Schlierbach;1981;2352;18;2370
AT31;40918;Spital am Pyhrn;1981;2259;18;2277
AT31;40919;Steinbach am Ziehberg;1981;788;7;795
AT31;40920;Steinbach an der Steyr;1981;1897;15;1912
AT31;40921;Vorderstoder;1981;688;4;692
AT31;40922;Wartberg an der Krems;1981;2399;11;2410
AT31;40923;Windischgarsten;1981;1931;12;1943
AT31;41001;Allhaming;1981;621;17;638
AT31;41002;Ansfelden;1981;12226;1098;13324
AT31;41003;Asten;1981;3330;101;3431
AT31;41004;Eggendorf im Traunkreis;1981;515;1;516
AT31;41005;Enns;1981;9294;434;9728
AT31;41006;Hargelsberg;1981;782;0;782
AT31;41007;Hörsching;1981;4405;278;4683
AT31;41008;Hofkirchen im Traunkreis;1981;1026;4;1030
AT31;41009;Kematen an der Krems;1981;1711;72;1783
AT31;41010;Kirchberg-Thening;1981;1851;21;1872
AT31;41011;Kronstorf;1981;2259;19;2278
AT31;41012;Leonding;1981;18722;667;19389
AT31;41013;St. Florian;1981;4055;74;4129
AT31;41014;Neuhofen an der Krems;1981;4115;84;4199
AT31;41015;Niederneukirchen;1981;1437;3;1440
AT31;41016;Oftering;1981;1611;7;1618
AT31;41017;Pasching;1981;6005;320;6325
AT31;41018;Piberbach;1981;1408;3;1411
AT31;41019;Pucking;1981;2166;55;2221
AT31;41020;St. Marien;1981;2786;7;2793
AT31;41021;Traun;1981;19601;1863;21464
AT31;41022;Wilhering;1981;4052;56;4108
AT31;41101;Allerheiligen im Mühlkreis;1981;1053;1;1054
AT31;41102;Arbing;1981;1122;27;1149
AT31;41103;Baumgartenberg;1981;1371;31;1402
AT31;41104;Dimbach;1981;1125;0;1125
AT31;41105;Grein;1981;2800;17;2817
AT31;41106;Katsdorf;1981;1818;0;1818
AT31;41107;Klam;1981;661;1;662
AT31;41108;Bad Kreuzen;1981;2022;458;2480
AT31;41109;Langenstein;1981;2123;35;2158
AT31;41110;Luftenberg an der Donau;1981;3071;8;3079
AT31;41111;Mauthausen;1981;4198;148;4346
AT31;41112;Mitterkirchen im Machland;1981;1617;0;1617
AT31;41113;Münzbach;1981;1479;0;1479
AT31;41114;Naarn im Machlande;1981;2931;42;2973
AT31;41115;Pabneukirchen;1981;1688;0;1688
AT31;41116;Perg;1981;5126;81;5207
AT31;41117;Rechberg;1981;649;0;649
AT31;41118;Ried in der Riedmark;1981;3063;18;3081
AT31;41119;St. Georgen am Walde;1981;2172;31;2203
AT31;41120;St. Georgen an der Gusen;1981;3076;17;3093
AT31;41121;St. Nikola an der Donau;1981;855;90;945
AT31;41122;St. Thomas am Blasenstein;1981;988;17;1005
AT31;41123;Saxen;1981;1559;124;1683
AT31;41124;Schwertberg;1981;4347;19;4366
AT31;41125;Waldhausen im Strudengau;1981;2579;13;2592
AT31;41126;Windhaag bei Perg;1981;1111;27;1138
AT31;41201;Andrichsfurt;1981;705;2;707
AT31;41202;Antiesenhofen;1981;930;27;957
AT31;41203;Aurolzmünster;1981;2449;46;2495
AT31;41204;Eberschwang;1981;3161;30;3191
AT31;41205;Eitzing;1981;625;5;630
AT31;41206;Geiersberg;1981;520;0;520
AT31;41207;Geinberg;1981;1312;11;1323
AT31;41208;Gurten;1981;1137;5;1142
AT31;41209;Hohenzell;1981;1783;4;1787
AT31;41210;Kirchdorf am Inn;1981;636;3;639
AT31;41211;Kirchheim im Innkreis;1981;588;0;588
AT31;41212;Lambrechten;1981;1239;7;1246
AT31;41213;Lohnsburg am Kobernaußerwald;1981;2120;9;2129
AT31;41214;Mehrnbach;1981;2063;12;2075
AT31;41215;Mettmach;1981;2466;7;2473
AT31;41216;Mörschwang;1981;321;3;324
AT31;41217;Mühlheim am Inn;1981;657;5;662
AT31;41218;Neuhofen im Innkreis;1981;1475;23;1498
AT31;41219;Obernberg am Inn;1981;1611;66;1677
AT31;41220;Ort im Innkreis;1981;1164;5;1169
AT31;41221;Pattigham;1981;785;0;785
AT31;41222;Peterskirchen;1981;699;56;755
AT31;41223;Pramet;1981;903;3;906
AT31;41224;Reichersberg;1981;1405;20;1425
AT31;41225;Ried im Innkreis;1981;10537;318;10855
AT31;41226;St. Georgen bei Obernberg am Inn;1981;598;6;604
AT31;41227;St. Marienkirchen am Hausruck;1981;549;4;553
AT31;41228;St. Martin im Innkreis;1981;1391;43;1434
AT31;41229;Schildorn;1981;868;2;870
AT31;41230;Senftenbach;1981;628;6;634
AT31;41231;Taiskirchen im Innkreis;1981;2356;9;2365
AT31;41232;Tumeltsham;1981;1027;62;1089
AT31;41233;Utzenaich;1981;1335;13;1348
AT31;41234;Waldzell;1981;1927;4;1931
AT31;41235;Weilbach;1981;641;0;641
AT31;41236;Wippenham;1981;509;0;509
AT31;41304;Altenfelden;1981;2016;5;2021
AT31;41305;Arnreit;1981;1031;1;1032
AT31;41306;Atzesberg;1981;480;23;503
AT31;41307;Auberg;1981;556;0;556
AT31;41309;Haslach an der Mühl;1981;2638;11;2649
AT31;41311;Hörbich;1981;437;13;450
AT31;41312;Hofkirchen im Mühlkreis;1981;1403;12;1415
AT31;41313;Julbach;1981;1675;6;1681
AT31;41314;Kirchberg ob der Donau;1981;1104;11;1115
AT31;41315;Klaffer am Hochficht;1981;1257;42;1299
AT31;41316;Kleinzell im Mühlkreis;1981;1380;11;1391
AT31;41317;Kollerschlag;1981;1419;13;1432
AT31;41318;Lembach im Mühlkreis;1981;1304;26;1330
AT31;41319;Lichtenau im Mühlkreis;1981;610;6;616
AT31;41320;Nebelberg;1981;608;5;613
AT31;41321;Neufelden;1981;1152;9;1161
AT31;41322;Niederkappel;1981;1094;6;1100
AT31;41323;Niederwaldkirchen;1981;1608;4;1612
AT31;41324;Oberkappel;1981;775;49;824
AT31;41325;Oepping;1981;1448;0;1448
AT31;41326;Peilstein im Mühlviertel;1981;1630;26;1656
AT31;41327;Pfarrkirchen im Mühlkreis;1981;1507;10;1517
AT31;41328;Putzleinsdorf;1981;1540;27;1567
AT31;41329;Neustift im Mühlkreis;1981;1395;10;1405
AT31;41331;St. Johann am Wimberg;1981;944;6;950
AT31;41332;St. Martin im Mühlkreis;1981;2645;80;2725
AT31;41333;St. Oswald bei Haslach;1981;526;5;531
AT31;41334;St. Peter am Wimberg;1981;1583;0;1583
AT31;41336;St. Ulrich im Mühlkreis;1981;583;2;585
AT31;41337;St. Veit im Mühlkreis;1981;1054;0;1054
AT31;41338;Sarleinsbach;1981;2135;72;2207
AT31;41341;Schwarzenberg am Böhmerwald;1981;713;41;754
AT31;41342;Ulrichsberg;1981;3045;59;3104
AT31;41343;Aigen-Schlägl;1981;3178;55;3233
AT31;41344;Rohrbach-Berg;1981;4387;18;4405
AT31;41345;Helfenberg;1981;1625;0;1625
AT31;41346;St. Stefan-Afiesl;1981;1272;1;1273
AT31;41401;Altschwendt;1981;676;3;679
AT31;41402;Andorf;1981;4381;16;4397
AT31;41403;Brunnenthal;1981;1415;14;1429
AT31;41404;Diersbach;1981;1664;4;1668
AT31;41405;Dorf an der Pram;1981;930;10;940
AT31;41406;Eggerding;1981;1297;8;1305
AT31;41407;Engelhartszell;1981;1163;55;1218
AT31;41408;Enzenkirchen;1981;1673;46;1719
AT31;41409;Esternberg;1981;2531;70;2601
AT31;41410;Freinberg;1981;1331;156;1487
AT31;41411;Kopfing im Innkreis;1981;1994;21;2015
AT31;41412;Mayrhof;1981;241;0;241
AT31;41413;Münzkirchen;1981;2392;20;2412
AT31;41414;Raab;1981;2164;19;2183
AT31;41415;Rainbach im Innkreis;1981;1439;5;1444
AT31;41416;Riedau;1981;1691;16;1707
AT31;41417;St. Aegidi;1981;1622;14;1636
AT31;41418;St. Florian am Inn;1981;2611;112;2723
AT31;41419;St. Marienkirchen bei Schärding;1981;1800;29;1829
AT31;41420;St. Roman;1981;1692;3;1695
AT31;41421;St. Willibald;1981;1062;5;1067
AT31;41422;Schärding;1981;5648;93;5741
AT31;41423;Schardenberg;1981;2196;84;2280
AT31;41424;Sigharting;1981;740;28;768
AT31;41425;Suben;1981;1322;23;1345
AT31;41426;Taufkirchen an der Pram;1981;2692;46;2738
AT31;41427;Vichtenstein;1981;639;56;695
AT31;41428;Waldkirchen am Wesen;1981;1356;2;1358
AT31;41429;Wernstein am Inn;1981;1536;18;1554
AT31;41430;Zell an der Pram;1981;2008;18;2026
AT31;41501;Adlwang;1981;1219;11;1230
AT31;41502;Aschach an der Steyr;1981;1558;21;1579
AT31;41503;Bad Hall;1981;3942;101;4043
AT31;41504;Dietach;1981;1786;52;1838
AT31;41505;Gaflenz;1981;1654;5;1659
AT31;41506;Garsten;1981;5916;116;6032
AT31;41507;Großraming;1981;2840;17;2857
AT31;41508;Laussa;1981;1251;18;1269
AT31;41509;Losenstein;1981;1842;13;1855
AT31;41510;Maria Neustift;1981;1555;0;1555
AT31;41511;Pfarrkirchen bei Bad Hall;1981;1735;42;1777
AT31;41512;Reichraming;1981;1944;7;1951
AT31;41513;Rohr im Kremstal;1981;988;21;1009
AT31;41514;St. Ulrich bei Steyr;1981;2744;15;2759
AT31;41515;Schiedlberg;1981;1231;8;1239
AT31;41516;Sierning;1981;7846;38;7884
AT31;41517;Ternberg;1981;3098;36;3134
AT31;41518;Waldneukirchen;1981;1939;23;1962
AT31;41521;Wolfern;1981;2454;7;2461
AT31;41522;Weyer;1981;4737;28;4765
AT31;41601;Alberndorf in der Riedmark;1981;2695;2;2697
AT31;41602;Altenberg bei Linz;1981;2834;19;2853
AT31;41603;Bad Leonfelden;1981;3035;13;3048
AT31;41604;Eidenberg;1981;1527;7;1534
AT31;41605;Engerwitzdorf;1981;5214;44;5258
AT31;41606;Feldkirchen an der Donau;1981;4028;14;4042
AT31;41607;Gallneukirchen;1981;4357;41;4398
AT31;41608;Goldwörth;1981;620;0;620
AT31;41609;Gramastetten;1981;3627;36;3663
AT31;41610;Haibach im Mühlkreis;1981;551;5;556
AT31;41611;Hellmonsödt;1981;1418;15;1433
AT31;41612;Herzogsdorf;1981;1967;4;1971
AT31;41613;Kirchschlag bei Linz;1981;1369;9;1378
AT31;41614;Lichtenberg;1981;1547;7;1554
AT31;41615;Oberneukirchen;1981;2809;10;2819
AT31;41616;Ottenschlag im Mühlkreis;1981;445;1;446
AT31;41617;Ottensheim;1981;3485;94;3579
AT31;41618;Puchenau;1981;3283;85;3368
AT31;41619;Reichenau im Mühlkreis;1981;809;2;811
AT31;41620;Reichenthal;1981;1303;0;1303
AT31;41621;St. Gotthard im Mühlkreis;1981;1028;7;1035
AT31;41622;Schenkenfelden;1981;1101;0;1101
AT31;41623;Sonnberg im Mühlkreis;1981;665;0;665
AT31;41624;Steyregg;1981;4341;53;4394
AT31;41626;Walding;1981;2834;7;2841
AT31;41627;Zwettl an der Rodl;1981;1405;13;1418
AT31;41628;Vorderweißenbach;1981;2628;12;2640
AT31;41701;Ampflwang im Hausruckwald;1981;3850;16;3866
AT31;41702;Attersee am Attersee;1981;1320;24;1344
AT31;41703;Attnang-Puchheim;1981;7656;388;8044
AT31;41704;Atzbach;1981;1073;3;1076
AT31;41705;Aurach am Hongar;1981;1152;12;1164
AT31;41706;Berg im Attergau;1981;876;182;1058
AT31;41707;Desselbrunn;1981;1399;5;1404
AT31;41708;Fornach;1981;707;3;710
AT31;41709;Frankenburg am Hausruck;1981;4637;32;4669
AT31;41710;Frankenmarkt;1981;3087;73;3160
AT31;41711;Gampern;1981;1998;12;2010
AT31;41712;Innerschwand am Mondsee;1981;785;24;809
AT31;41713;Lenzing;1981;4972;94;5066
AT31;41714;Manning;1981;707;14;721
AT31;41715;Mondsee;1981;2050;88;2138
AT31;41716;Neukirchen an der Vöckla;1981;2278;9;2287
AT31;41717;Niederthalheim;1981;1037;0;1037
AT31;41718;Nußdorf am Attersee;1981;1025;97;1122
AT31;41719;Oberhofen am Irrsee;1981;1064;34;1098
AT31;41720;Oberndorf bei Schwanenstadt;1981;1136;7;1143
AT31;41721;Oberwang;1981;1359;6;1365
AT31;41722;Ottnang am Hausruck;1981;3770;23;3793
AT31;41723;Pfaffing;1981;1133;8;1141
AT31;41724;Pilsbach;1981;503;6;509
AT31;41725;Pitzenberg;1981;386;5;391
AT31;41726;Pöndorf;1981;1892;20;1912
AT31;41727;Puchkirchen am Trattberg;1981;720;0;720
AT31;41728;Pühret;1981;466;0;466
AT31;41729;Redleiten;1981;369;4;373
AT31;41730;Redlham;1981;1054;26;1080
AT31;41731;Regau;1981;4907;145;5052
AT31;41732;Rüstorf;1981;1811;80;1891
AT31;41733;Rutzenham;1981;217;0;217
AT31;41734;St. Georgen im Attergau;1981;2948;456;3404
AT31;41735;St. Lorenz;1981;1539;49;1588
AT31;41736;Schlatt;1981;1195;24;1219
AT31;41737;Schörfling am Attersee;1981;2880;49;2929
AT31;41738;Schwanenstadt;1981;3707;133;3840
AT31;41739;Seewalchen am Attersee;1981;3871;80;3951
AT31;41740;Steinbach am Attersee;1981;908;40;948
AT31;41741;Straß im Attergau;1981;1247;123;1370
AT31;41742;Tiefgraben;1981;2207;77;2284
AT31;41743;Timelkam;1981;5358;122;5480
AT31;41744;Ungenach;1981;1192;0;1192
AT31;41745;Unterach am Attersee;1981;1292;51;1343
AT31;41746;Vöcklabruck;1981;10657;362;11019
AT31;41747;Vöcklamarkt;1981;4108;93;4201
AT31;41748;Weißenkirchen im Attergau;1981;854;2;856
AT31;41749;Weyregg am Attersee;1981;1364;16;1380
AT31;41750;Wolfsegg am Hausruck;1981;2004;21;2025
AT31;41751;Zell am Moos;1981;1075;6;1081
AT31;41752;Zell am Pettenfirst;1981;1069;16;1085
AT31;41801;Aichkirchen;1981;491;0;491
AT31;41802;Bachmanning;1981;584;24;608
AT31;41803;Bad Wimsbach-Neydharting;1981;2139;46;2185
AT31;41804;Buchkirchen;1981;2946;56;3002
AT31;41805;Eberstalzell;1981;1757;139;1896
AT31;41806;Edt bei Lambach;1981;1617;47;1664
AT31;41807;Fischlham;1981;1064;16;1080
AT31;41808;Gunskirchen;1981;4220;151;4371
AT31;41809;Holzhausen;1981;569;4;573
AT31;41810;Krenglbach;1981;2049;44;2093
AT31;41811;Lambach;1981;3073;91;3164
AT31;41812;Marchtrenk;1981;8857;559;9416
AT31;41813;Neukirchen bei Lambach;1981;751;0;751
AT31;41814;Offenhausen;1981;1224;28;1252
AT31;41815;Pennewang;1981;764;5;769
AT31;41816;Pichl bei Wels;1981;2269;11;2280
AT31;41817;Sattledt;1981;1898;73;1971
AT31;41818;Schleißheim;1981;735;14;749
AT31;41819;Sipbachzell;1981;1352;10;1362
AT31;41820;Stadl-Paura;1981;4488;256;4744
AT31;41821;Steinerkirchen an der Traun;1981;2004;12;2016
AT31;41822;Steinhaus;1981;1636;35;1671
AT31;41823;Thalheim bei Wels;1981;3726;280;4006
AT31;41824;Weißkirchen an der Traun;1981;1759;19;1778
AT31;40101;Linz;1971;197466;7423;204889
AT31;40201;Steyr;1971;39716;1106;40822
AT31;40301;Wels;1971;45705;1822;47527
AT31;40401;Altheim;1971;4723;106;4829
AT31;40402;Aspach;1971;2225;23;2248
AT31;40403;Auerbach;1971;440;2;442
AT31;40404;Braunau am Inn;1971;15895;641;16536
AT31;40405;Burgkirchen;1971;2113;29;2142
AT31;40406;Eggelsberg;1971;1535;64;1599
AT31;40407;Feldkirchen bei Mattighofen;1971;1657;21;1678
AT31;40408;Franking;1971;601;9;610
AT31;40409;Geretsberg;1971;892;27;919
AT31;40410;Gilgenberg am Weilhart;1971;1090;8;1098
AT31;40411;Haigermoos;1971;420;6;426
AT31;40412;Handenberg;1971;1284;16;1300
AT31;40413;Helpfau-Uttendorf;1971;2573;47;2620
AT31;40414;Hochburg-Ach;1971;2828;164;2992
AT31;40415;Höhnhart;1971;1427;3;1430
AT31;40416;Jeging;1971;427;4;431
AT31;40417;Kirchberg bei Mattighofen;1971;813;2;815
AT31;40418;Lengau;1971;3806;91;3897
AT31;40419;Lochen am See;1971;1733;19;1752
AT31;40420;Maria Schmolln;1971;1152;5;1157
AT31;40421;Mattighofen;1971;4117;250;4367
AT31;40422;Mauerkirchen;1971;2179;58;2237
AT31;40423;Mining;1971;1036;10;1046
AT31;40424;Moosbach;1971;795;8;803
AT31;40425;Moosdorf;1971;1076;35;1111
AT31;40426;Munderfing;1971;2246;45;2291
AT31;40427;Neukirchen an der Enknach;1971;1834;14;1848
AT31;40428;Ostermiething;1971;2124;50;2174
AT31;40429;Palting;1971;675;0;675
AT31;40430;Perwang am Grabensee;1971;514;3;517
AT31;40431;Pfaffstätt;1971;705;5;710
AT31;40432;Pischelsdorf am Engelbach;1971;1426;39;1465
AT31;40433;Polling im Innkreis;1971;963;0;963
AT31;40434;Roßbach;1971;838;3;841
AT31;40435;St. Georgen am Fillmannsbach;1971;350;12;362
AT31;40436;St. Johann am Walde;1971;1936;2;1938
AT31;40437;St. Pantaleon;1971;2907;136;3043
AT31;40438;St. Peter am Hart;1971;1583;105;1688
AT31;40439;St. Radegund;1971;510;9;519
AT31;40440;St. Veit im Innkreis;1971;351;1;352
AT31;40441;Schalchen;1971;2899;97;2996
AT31;40442;Schwand im Innkreis;1971;844;5;849
AT31;40443;Tarsdorf;1971;1504;13;1517
AT31;40444;Treubach;1971;640;0;640
AT31;40445;Überackern;1971;506;9;515
AT31;40446;Weng im Innkreis;1971;1258;8;1266
AT31;40501;Alkoven;1971;3973;77;4050
AT31;40502;Aschach an der Donau;1971;2278;32;2310
AT31;40503;Eferding;1971;2983;40;3023
AT31;40504;Fraham;1971;1793;23;1816
AT31;40505;Haibach ob der Donau;1971;1234;1;1235
AT31;40506;Hartkirchen;1971;3571;14;3585
AT31;40507;Hinzenbach;1971;1651;22;1673
AT31;40508;Prambachkirchen;1971;2483;15;2498
AT31;40509;Pupping;1971;1697;10;1707
AT31;40510;St. Marienkirchen an der Polsenz;1971;1639;6;1645
AT31;40511;Scharten;1971;1460;6;1466
AT31;40512;Stroheim;1971;1483;0;1483
AT31;40601;Freistadt;1971;5902;61;5963
AT31;40602;Grünbach;1971;1563;6;1569
AT31;40603;Gutau;1971;2350;10;2360
AT31;40604;Hagenberg im Mühlkreis;1971;1570;13;1583
AT31;40605;Hirschbach im Mühlkreis;1971;1183;3;1186
AT31;40606;Kaltenberg;1971;701;0;701
AT31;40607;Kefermarkt;1971;1765;33;1798
AT31;40608;Königswiesen;1971;2921;0;2921
AT31;40609;Lasberg;1971;2269;1;2270
AT31;40610;Leopoldschlag;1971;1186;3;1189
AT31;40611;Liebenau;1971;2248;1;2249
AT31;40612;Neumarkt im Mühlkreis;1971;2481;4;2485
AT31;40613;Pierbach;1971;1011;0;1011
AT31;40614;Pregarten;1971;3229;81;3310
AT31;40615;Rainbach im Mühlkreis;1971;2772;4;2776
AT31;40616;Sandl;1971;1729;1;1730
AT31;40617;St. Leonhard bei Freistadt;1971;1555;0;1555
AT31;40618;St. Oswald bei Freistadt;1971;2271;2;2273
AT31;40619;Schönau im Mühlkreis;1971;1707;1;1708
AT31;40620;Tragwein;1971;2766;2;2768
AT31;40621;Unterweißenbach;1971;2474;0;2474
AT31;40622;Unterweitersdorf;1971;887;6;893
AT31;40623;Waldburg;1971;1219;8;1227
AT31;40624;Wartberg ob der Aist;1971;2400;9;2409
AT31;40625;Weitersfelden;1971;1373;1;1374
AT31;40626;Windhaag bei Freistadt;1971;1864;22;1886
AT31;40627;Bad Zell;1971;2570;1;2571
AT31;40701;Altmünster;1971;7734;187;7921
AT31;40702;Bad Goisern am Hallstättersee;1971;6276;153;6429
AT31;40703;Bad Ischl;1971;12437;375;12812
AT31;40704;Ebensee am Traunsee;1971;9326;140;9466
AT31;40705;Gmunden;1971;11989;342;12331
AT31;40706;Gosau;1971;1779;27;1806
AT31;40707;Grünau im Almtal;1971;2147;10;2157
AT31;40708;Gschwandt;1971;1958;37;1995
AT31;40709;Hallstatt;1971;1285;25;1310
AT31;40710;Kirchham;1971;1490;11;1501
AT31;40711;Laakirchen;1971;7530;157;7687
AT31;40712;Obertraun;1971;764;17;781
AT31;40713;Ohlsdorf;1971;3030;27;3057
AT31;40714;Pinsdorf;1971;2643;73;2716
AT31;40715;Roitham am Traunfall;1971;1832;19;1851
AT31;40716;St. Konrad;1971;745;2;747
AT31;40717;St. Wolfgang im Salzkammergut;1971;2400;97;2497
AT31;40718;Traunkirchen;1971;1531;38;1569
AT31;40719;Scharnstein;1971;3851;89;3940
AT31;40720;Vorchdorf;1971;5561;133;5694
AT31;40801;Aistersheim;1971;641;0;641
AT31;40802;Bad Schallerbach;1971;2352;43;2395
AT31;40804;Eschenau im Hausruckkreis;1971;1038;2;1040
AT31;40805;Gallspach;1971;1831;36;1867
AT31;40806;Gaspoltshofen;1971;3136;31;3167
AT31;40807;Geboltskirchen;1971;1363;24;1387
AT31;40808;Grieskirchen;1971;4462;72;4534
AT31;40809;Haag am Hausruck;1971;1948;34;1982
AT31;40810;Heiligenberg;1971;662;0;662
AT31;40811;Hofkirchen an der Trattnach;1971;1337;13;1350
AT31;40812;Kallham;1971;2667;15;2682
AT31;40813;Kematen am Innbach;1971;1018;0;1018
AT31;40814;Meggenhofen;1971;1158;4;1162
AT31;40815;Michaelnbach;1971;1158;2;1160
AT31;40816;Natternbach;1971;1994;10;2004
AT31;40817;Neukirchen am Walde;1971;1618;2;1620
AT31;40818;Neumarkt im Hausruckkreis;1971;1495;12;1507
AT31;40820;Pötting;1971;476;0;476
AT31;40821;Pollham;1971;837;0;837
AT31;40822;Pram;1971;1772;4;1776
AT31;40823;Rottenbach;1971;871;10;881
AT31;40824;St. Agatha;1971;1831;4;1835
AT31;40825;St. Georgen bei Grieskirchen;1971;800;3;803
AT31;40826;St. Thomas;1971;357;12;369
AT31;40827;Schlüßlberg;1971;2262;14;2276
AT31;40828;Steegen;1971;1004;1;1005
AT31;40829;Taufkirchen an der Trattnach;1971;1788;3;1791
AT31;40830;Tollet;1971;630;4;634
AT31;40831;Waizenkirchen;1971;3516;36;3552
AT31;40832;Wallern an der Trattnach;1971;2082;26;2108
AT31;40833;Weibern;1971;1398;53;1451
AT31;40834;Wendling;1971;724;1;725
AT31;40835;Peuerbach;1971;4179;23;4202
AT31;40901;Edlbach;1971;532;11;543
AT31;40902;Grünburg;1971;3687;110;3797
AT31;40903;Hinterstoder;1971;974;26;1000
AT31;40904;Inzersdorf im Kremstal;1971;1596;6;1602
AT31;40905;Kirchdorf an der Krems;1971;3416;96;3512
AT31;40906;Klaus an der Pyhrnbahn;1971;1216;30;1246
AT31;40907;Kremsmünster;1971;5504;199;5703
AT31;40908;Micheldorf in Oberösterreich;1971;4179;90;4269
AT31;40909;Molln;1971;3349;170;3519
AT31;40910;Nußbach;1971;1789;13;1802
AT31;40911;Oberschlierbach;1971;370;7;377
AT31;40912;Pettenbach;1971;3839;35;3874
AT31;40913;Ried im Traunkreis;1971;1966;7;1973
AT31;40914;Rosenau am Hengstpaß;1971;883;45;928
AT31;40915;Roßleithen;1971;1703;19;1722
AT31;40916;St. Pankraz;1971;407;1;408
AT31;40917;Schlierbach;1971;2240;10;2250
AT31;40918;Spital am Pyhrn;1971;2295;20;2315
AT31;40919;Steinbach am Ziehberg;1971;817;3;820
AT31;40920;Steinbach an der Steyr;1971;1890;21;1911
AT31;40921;Vorderstoder;1971;678;18;696
AT31;40922;Wartberg an der Krems;1971;2363;13;2376
AT31;40923;Windischgarsten;1971;1778;27;1805
AT31;41001;Allhaming;1971;617;12;629
AT31;41002;Ansfelden;1971;10295;779;11074
AT31;41003;Asten;1971;1905;65;1970
AT31;41004;Eggendorf im Traunkreis;1971;454;3;457
AT31;41005;Enns;1971;9309;368;9677
AT31;41006;Hargelsberg;1971;755;0;755
AT31;41007;Hörsching;1971;3909;254;4163
AT31;41008;Hofkirchen im Traunkreis;1971;852;3;855
AT31;41009;Kematen an der Krems;1971;1644;35;1679
AT31;41010;Kirchberg-Thening;1971;1773;30;1803
AT31;41011;Kronstorf;1971;2180;29;2209
AT31;41012;Leonding;1971;14469;499;14968
AT31;41013;St. Florian;1971;3782;61;3843
AT31;41014;Neuhofen an der Krems;1971;3630;43;3673
AT31;41015;Niederneukirchen;1971;1196;20;1216
AT31;41016;Oftering;1971;1513;19;1532
AT31;41017;Pasching;1971;5787;294;6081
AT31;41018;Piberbach;1971;1367;9;1376
AT31;41019;Pucking;1971;1727;20;1747
AT31;41020;St. Marien;1971;2475;13;2488
AT31;41021;Traun;1971;19794;1421;21215
AT31;41022;Wilhering;1971;3636;443;4079
AT31;41101;Allerheiligen im Mühlkreis;1971;984;4;988
AT31;41102;Arbing;1971;1073;0;1073
AT31;41103;Baumgartenberg;1971;1236;3;1239
AT31;41104;Dimbach;1971;1160;0;1160
AT31;41105;Grein;1971;2764;3;2767
AT31;41106;Katsdorf;1971;1557;0;1557
AT31;41107;Klam;1971;642;2;644
AT31;41108;Bad Kreuzen;1971;2077;11;2088
AT31;41109;Langenstein;1971;1879;79;1958
AT31;41110;Luftenberg an der Donau;1971;2537;6;2543
AT31;41111;Mauthausen;1971;4398;34;4432
AT31;41112;Mitterkirchen im Machland;1971;1530;3;1533
AT31;41113;Münzbach;1971;1443;1;1444
AT31;41114;Naarn im Machlande;1971;2765;3;2768
AT31;41115;Pabneukirchen;1971;1682;4;1686
AT31;41116;Perg;1971;4844;69;4913
AT31;41117;Rechberg;1971;650;0;650
AT31;41118;Ried in der Riedmark;1971;2863;12;2875
AT31;41119;St. Georgen am Walde;1971;2205;2;2207
AT31;41120;St. Georgen an der Gusen;1971;2797;8;2805
AT31;41121;St. Nikola an der Donau;1971;1006;10;1016
AT31;41122;St. Thomas am Blasenstein;1971;947;0;947
AT31;41123;Saxen;1971;1581;0;1581
AT31;41124;Schwertberg;1971;3864;37;3901
AT31;41125;Waldhausen im Strudengau;1971;2624;14;2638
AT31;41126;Windhaag bei Perg;1971;1000;2;1002
AT31;41201;Andrichsfurt;1971;701;0;701
AT31;41202;Antiesenhofen;1971;891;17;908
AT31;41203;Aurolzmünster;1971;2493;105;2598
AT31;41204;Eberschwang;1971;3228;11;3239
AT31;41205;Eitzing;1971;592;4;596
AT31;41206;Geiersberg;1971;486;8;494
AT31;41207;Geinberg;1971;1411;7;1418
AT31;41208;Gurten;1971;1079;26;1105
AT31;41209;Hohenzell;1971;1606;9;1615
AT31;41210;Kirchdorf am Inn;1971;673;3;676
AT31;41211;Kirchheim im Innkreis;1971;575;5;580
AT31;41212;Lambrechten;1971;1301;7;1308
AT31;41213;Lohnsburg am Kobernaußerwald;1971;2082;3;2085
AT31;41214;Mehrnbach;1971;1925;25;1950
AT31;41215;Mettmach;1971;2356;7;2363
AT31;41216;Mörschwang;1971;295;1;296
AT31;41217;Mühlheim am Inn;1971;616;12;628
AT31;41218;Neuhofen im Innkreis;1971;1314;8;1322
AT31;41219;Obernberg am Inn;1971;1720;24;1744
AT31;41220;Ort im Innkreis;1971;1145;4;1149
AT31;41221;Pattigham;1971;769;1;770
AT31;41222;Peterskirchen;1971;683;4;687
AT31;41223;Pramet;1971;882;2;884
AT31;41224;Reichersberg;1971;1352;17;1369
AT31;41225;Ried im Innkreis;1971;10317;441;10758
AT31;41226;St. Georgen bei Obernberg am Inn;1971;595;0;595
AT31;41227;St. Marienkirchen am Hausruck;1971;518;1;519
AT31;41228;St. Martin im Innkreis;1971;1423;44;1467
AT31;41229;Schildorn;1971;885;0;885
AT31;41230;Senftenbach;1971;617;3;620
AT31;41231;Taiskirchen im Innkreis;1971;2292;0;2292
AT31;41232;Tumeltsham;1971;933;18;951
AT31;41233;Utzenaich;1971;1438;10;1448
AT31;41234;Waldzell;1971;1893;1;1894
AT31;41235;Weilbach;1971;654;3;657
AT31;41236;Wippenham;1971;509;13;522
AT31;41304;Altenfelden;1971;1956;6;1962
AT31;41305;Arnreit;1971;981;1;982
AT31;41306;Atzesberg;1971;539;2;541
AT31;41307;Auberg;1971;548;0;548
AT31;41309;Haslach an der Mühl;1971;2631;10;2641
AT31;41311;Hörbich;1971;468;5;473
AT31;41312;Hofkirchen im Mühlkreis;1971;1338;1;1339
AT31;41313;Julbach;1971;1623;6;1629
AT31;41314;Kirchberg ob der Donau;1971;1111;5;1116
AT31;41315;Klaffer am Hochficht;1971;1231;5;1236
AT31;41316;Kleinzell im Mühlkreis;1971;1355;15;1370
AT31;41317;Kollerschlag;1971;1332;11;1343
AT31;41318;Lembach im Mühlkreis;1971;1315;7;1322
AT31;41319;Lichtenau im Mühlkreis;1971;615;15;630
AT31;41320;Nebelberg;1971;634;0;634
AT31;41321;Neufelden;1971;1101;8;1109
AT31;41322;Niederkappel;1971;1123;1;1124
AT31;41323;Niederwaldkirchen;1971;1568;10;1578
AT31;41324;Oberkappel;1971;731;5;736
AT31;41325;Oepping;1971;1405;8;1413
AT31;41326;Peilstein im Mühlviertel;1971;1633;5;1638
AT31;41327;Pfarrkirchen im Mühlkreis;1971;1491;5;1496
AT31;41328;Putzleinsdorf;1971;1455;5;1460
AT31;41329;Neustift im Mühlkreis;1971;1338;11;1349
AT31;41331;St. Johann am Wimberg;1971;970;2;972
AT31;41332;St. Martin im Mühlkreis;1971;2309;50;2359
AT31;41333;St. Oswald bei Haslach;1971;488;3;491
AT31;41334;St. Peter am Wimberg;1971;1461;1;1462
AT31;41336;St. Ulrich im Mühlkreis;1971;508;3;511
AT31;41337;St. Veit im Mühlkreis;1971;1020;5;1025
AT31;41338;Sarleinsbach;1971;2149;3;2152
AT31;41341;Schwarzenberg am Böhmerwald;1971;726;6;732
AT31;41342;Ulrichsberg;1971;3045;25;3070
AT31;41343;Aigen-Schlägl;1971;3203;36;3239
AT31;41344;Rohrbach-Berg;1971;4264;14;4278
AT31;41345;Helfenberg;1971;1688;9;1697
AT31;41346;St. Stefan-Afiesl;1971;1204;4;1208
AT31;41401;Altschwendt;1971;652;8;660
AT31;41402;Andorf;1971;4390;19;4409
AT31;41403;Brunnenthal;1971;1259;18;1277
AT31;41404;Diersbach;1971;1733;9;1742
AT31;41405;Dorf an der Pram;1971;919;4;923
AT31;41406;Eggerding;1971;1268;5;1273
AT31;41407;Engelhartszell;1971;1195;43;1238
AT31;41408;Enzenkirchen;1971;1666;17;1683
AT31;41409;Esternberg;1971;2453;26;2479
AT31;41410;Freinberg;1971;1390;63;1453
AT31;41411;Kopfing im Innkreis;1971;1927;28;1955
AT31;41412;Mayrhof;1971;230;0;230
AT31;41413;Münzkirchen;1971;2239;4;2243
AT31;41414;Raab;1971;2192;15;2207
AT31;41415;Rainbach im Innkreis;1971;1305;3;1308
AT31;41416;Riedau;1971;1663;32;1695
AT31;41417;St. Aegidi;1971;1547;8;1555
AT31;41418;St. Florian am Inn;1971;2597;108;2705
AT31;41419;St. Marienkirchen bei Schärding;1971;1715;19;1734
AT31;41420;St. Roman;1971;1645;2;1647
AT31;41421;St. Willibald;1971;1039;8;1047
AT31;41422;Schärding;1971;5736;155;5891
AT31;41423;Schardenberg;1971;2163;16;2179
AT31;41424;Sigharting;1971;780;1;781
AT31;41425;Suben;1971;1314;29;1343
AT31;41426;Taufkirchen an der Pram;1971;2708;15;2723
AT31;41427;Vichtenstein;1971;615;29;644
AT31;41428;Waldkirchen am Wesen;1971;1468;16;1484
AT31;41429;Wernstein am Inn;1971;1497;41;1538
AT31;41430;Zell an der Pram;1971;2002;11;2013
AT31;41501;Adlwang;1971;1094;12;1106
AT31;41502;Aschach an der Steyr;1971;1401;15;1416
AT31;41503;Bad Hall;1971;3941;110;4051
AT31;41504;Dietach;1971;1500;6;1506
AT31;41505;Gaflenz;1971;1580;7;1587
AT31;41506;Garsten;1971;5869;84;5953
AT31;41507;Großraming;1971;2932;6;2938
AT31;41508;Laussa;1971;1315;22;1337
AT31;41509;Losenstein;1971;1871;65;1936
AT31;41510;Maria Neustift;1971;1582;9;1591
AT31;41511;Pfarrkirchen bei Bad Hall;1971;1477;54;1531
AT31;41512;Reichraming;1971;2170;7;2177
AT31;41513;Rohr im Kremstal;1971;993;26;1019
AT31;41514;St. Ulrich bei Steyr;1971;2547;26;2573
AT31;41515;Schiedlberg;1971;1363;16;1379
AT31;41516;Sierning;1971;8106;77;8183
AT31;41517;Ternberg;1971;2988;36;3024
AT31;41518;Waldneukirchen;1971;1897;24;1921
AT31;41521;Wolfern;1971;2147;16;2163
AT31;41522;Weyer;1971;5013;74;5087
AT31;41601;Alberndorf in der Riedmark;1971;2513;21;2534
AT31;41602;Altenberg bei Linz;1971;2108;5;2113
AT31;41603;Bad Leonfelden;1971;2697;15;2712
AT31;41604;Eidenberg;1971;1368;8;1376
AT31;41605;Engerwitzdorf;1971;4112;19;4131
AT31;41606;Feldkirchen an der Donau;1971;3763;32;3795
AT31;41607;Gallneukirchen;1971;3601;60;3661
AT31;41608;Goldwörth;1971;575;1;576
AT31;41609;Gramastetten;1971;2777;15;2792
AT31;41610;Haibach im Mühlkreis;1971;474;3;477
AT31;41611;Hellmonsödt;1971;1207;3;1210
AT31;41612;Herzogsdorf;1971;1783;10;1793
AT31;41613;Kirchschlag bei Linz;1971;1178;20;1198
AT31;41614;Lichtenberg;1971;1196;10;1206
AT31;41615;Oberneukirchen;1971;2712;10;2722
AT31;41616;Ottenschlag im Mühlkreis;1971;428;0;428
AT31;41617;Ottensheim;1971;3088;57;3145
AT31;41618;Puchenau;1971;2225;76;2301
AT31;41619;Reichenau im Mühlkreis;1971;803;3;806
AT31;41620;Reichenthal;1971;1220;5;1225
AT31;41621;St. Gotthard im Mühlkreis;1971;964;11;975
AT31;41622;Schenkenfelden;1971;1059;0;1059
AT31;41623;Sonnberg im Mühlkreis;1971;606;0;606
AT31;41624;Steyregg;1971;3782;23;3805
AT31;41626;Walding;1971;2414;8;2422
AT31;41627;Zwettl an der Rodl;1971;1190;0;1190
AT31;41628;Vorderweißenbach;1971;2604;3;2607
AT31;41701;Ampflwang im Hausruckwald;1971;3919;31;3950
AT31;41702;Attersee am Attersee;1971;1347;36;1383
AT31;41703;Attnang-Puchheim;1971;7675;265;7940
AT31;41704;Atzbach;1971;1023;7;1030
AT31;41705;Aurach am Hongar;1971;1042;1;1043
AT31;41706;Berg im Attergau;1971;817;3;820
AT31;41707;Desselbrunn;1971;1371;5;1376
AT31;41708;Fornach;1971;684;6;690
AT31;41709;Frankenburg am Hausruck;1971;4554;21;4575
AT31;41710;Frankenmarkt;1971;2923;54;2977
AT31;41711;Gampern;1971;1851;11;1862
AT31;41712;Innerschwand am Mondsee;1971;741;4;745
AT31;41713;Lenzing;1971;5322;84;5406
AT31;41714;Manning;1971;667;25;692
AT31;41715;Mondsee;1971;2074;76;2150
AT31;41716;Neukirchen an der Vöckla;1971;2261;18;2279
AT31;41717;Niederthalheim;1971;1000;3;1003
AT31;41718;Nußdorf am Attersee;1971;885;16;901
AT31;41719;Oberhofen am Irrsee;1971;1037;13;1050
AT31;41720;Oberndorf bei Schwanenstadt;1971;958;22;980
AT31;41721;Oberwang;1971;1293;2;1295
AT31;41722;Ottnang am Hausruck;1971;3912;16;3928
AT31;41723;Pfaffing;1971;939;17;956
AT31;41724;Pilsbach;1971;497;7;504
AT31;41725;Pitzenberg;1971;332;0;332
AT31;41726;Pöndorf;1971;1844;3;1847
AT31;41727;Puchkirchen am Trattberg;1971;730;0;730
AT31;41728;Pühret;1971;419;0;419
AT31;41729;Redleiten;1971;328;4;332
AT31;41730;Redlham;1971;920;14;934
AT31;41731;Regau;1971;4562;142;4704
AT31;41732;Rüstorf;1971;1914;87;2001
AT31;41733;Rutzenham;1971;214;0;214
AT31;41734;St. Georgen im Attergau;1971;2857;137;2994
AT31;41735;St. Lorenz;1971;1410;45;1455
AT31;41736;Schlatt;1971;1066;23;1089
AT31;41737;Schörfling am Attersee;1971;2787;41;2828
AT31;41738;Schwanenstadt;1971;3952;141;4093
AT31;41739;Seewalchen am Attersee;1971;3679;156;3835
AT31;41740;Steinbach am Attersee;1971;895;5;900
AT31;41741;Straß im Attergau;1971;1266;21;1287
AT31;41742;Tiefgraben;1971;1864;37;1901
AT31;41743;Timelkam;1971;4950;101;5051
AT31;41744;Ungenach;1971;1109;6;1115
AT31;41745;Unterach am Attersee;1971;1284;65;1349
AT31;41746;Vöcklabruck;1971;10303;429;10732
AT31;41747;Vöcklamarkt;1971;4089;60;4149
AT31;41748;Weißenkirchen im Attergau;1971;863;2;865
AT31;41749;Weyregg am Attersee;1971;1399;2;1401
AT31;41750;Wolfsegg am Hausruck;1971;2054;13;2067
AT31;41751;Zell am Moos;1971;988;5;993
AT31;41752;Zell am Pettenfirst;1971;987;1;988
AT31;41801;Aichkirchen;1971;433;2;435
AT31;41802;Bachmanning;1971;601;14;615
AT31;41803;Bad Wimsbach-Neydharting;1971;2045;37;2082
AT31;41804;Buchkirchen;1971;2597;31;2628
AT31;41805;Eberstalzell;1971;1653;17;1670
AT31;41806;Edt bei Lambach;1971;1583;55;1638
AT31;41807;Fischlham;1971;1012;10;1022
AT31;41808;Gunskirchen;1971;4172;150;4322
AT31;41809;Holzhausen;1971;562;13;575
AT31;41810;Krenglbach;1971;1755;20;1775
AT31;41811;Lambach;1971;3225;88;3313
AT31;41812;Marchtrenk;1971;8521;352;8873
AT31;41813;Neukirchen bei Lambach;1971;685;0;685
AT31;41814;Offenhausen;1971;1265;20;1285
AT31;41815;Pennewang;1971;835;8;843
AT31;41816;Pichl bei Wels;1971;2268;12;2280
AT31;41817;Sattledt;1971;1786;37;1823
AT31;41818;Schleißheim;1971;610;1;611
AT31;41819;Sipbachzell;1971;1260;7;1267
AT31;41820;Stadl-Paura;1971;4625;216;4841
AT31;41821;Steinerkirchen an der Traun;1971;1842;2;1844
AT31;41822;Steinhaus;1971;1603;33;1636
AT31;41823;Thalheim bei Wels;1971;3518;263;3781
AT31;41824;Weißkirchen an der Traun;1971;1429;59;1488
