NUTS2;LAU2_CODE;LAU2_NAME;YEAR;NATION_AUSTRIA;NATION_EU;NATION_FORMER_YUGOSLAVIA;NATION_TURKEY;NATION_OTHERS;NATION_TOTAL
AT31;40101;Linz;2021;152633;22416;12248;3574;16376;207247
AT31;40201;Steyr;2021;29851;3226;2349;937;1516;37879
AT31;40301;Wels;2021;44044;8326;5966;1668;3177;63181
AT31;40401;Altheim;2021;4220;564;159;14;50;5007
AT31;40402;Aspach;2021;2350;230;18;1;8;2607
AT31;40403;Auerbach;2021;648;65;39;6;12;770
AT31;40404;Braunau am Inn;2021;12600;2533;1215;159;979;17486
AT31;40405;Burgkirchen;2021;2411;234;73;0;9;2727
AT31;40406;Eggelsberg;2021;2323;268;30;4;32;2657
AT31;40407;Feldkirchen bei Mattighofen;2021;1951;121;15;2;11;2100
AT31;40408;Franking;2021;898;106;5;0;5;1014
AT31;40409;Geretsberg;2021;1071;85;1;0;14;1171
AT31;40410;Gilgenberg am Weilhart;2021;1204;132;7;0;16;1359
AT31;40411;Haigermoos;2021;593;41;1;0;2;637
AT31;40412;Handenberg;2021;1240;83;10;0;3;1336
AT31;40413;Helpfau-Uttendorf;2021;2789;648;249;19;47;3752
AT31;40414;Hochburg-Ach;2021;2488;784;15;2;53;3342
AT31;40415;Höhnhart;2021;1363;85;0;0;15;1463
AT31;40416;Jeging;2021;593;77;14;22;4;710
AT31;40417;Kirchberg bei Mattighofen;2021;1140;53;2;12;5;1212
AT31;40418;Lengau;2021;4342;383;160;52;38;4975
AT31;40419;Lochen am See;2021;2764;141;8;7;6;2926
AT31;40420;Maria Schmolln;2021;1352;64;5;2;19;1442
AT31;40421;Mattighofen;2021;4485;1337;1077;145;195;7239
AT31;40422;Mauerkirchen;2021;1934;451;223;1;44;2653
AT31;40423;Mining;2021;1162;84;3;2;8;1259
AT31;40424;Moosbach;2021;941;149;19;0;14;1123
AT31;40425;Moosdorf;2021;1545;181;12;0;17;1755
AT31;40426;Munderfing;2021;2633;262;80;14;32;3021
AT31;40427;Neukirchen an der Enknach;2021;2046;149;33;1;37;2266
AT31;40428;Ostermiething;2021;2859;381;76;9;29;3354
AT31;40429;Palting;2021;1082;48;8;4;10;1152
AT31;40430;Perwang am Grabensee;2021;983;81;2;1;8;1075
AT31;40431;Pfaffstätt;2021;929;241;42;2;2;1216
AT31;40432;Pischelsdorf am Engelbach;2021;1507;172;13;2;19;1713
AT31;40433;Polling im Innkreis;2021;928;57;6;0;7;998
AT31;40434;Roßbach;2021;830;54;4;0;4;892
AT31;40435;St. Georgen am Fillmannsbach;2021;424;25;1;0;0;450
AT31;40436;St. Johann am Walde;2021;1892;142;3;1;7;2045
AT31;40437;St. Pantaleon;2021;2692;312;132;11;60;3207
AT31;40438;St. Peter am Hart;2021;2112;257;11;18;61;2459
AT31;40439;St. Radegund;2021;548;86;3;0;0;637
AT31;40440;St. Veit im Innkreis;2021;377;29;0;0;2;408
AT31;40441;Schalchen;2021;3387;395;287;14;39;4122
AT31;40442;Schwand im Innkreis;2021;941;68;1;1;9;1020
AT31;40443;Tarsdorf;2021;1912;178;18;1;6;2115
AT31;40444;Treubach;2021;660;75;5;0;6;746
AT31;40445;Überackern;2021;489;201;0;0;4;694
AT31;40446;Weng im Innkreis;2021;1307;77;13;0;23;1420
AT31;40501;Alkoven;2021;5582;266;113;27;116;6104
AT31;40502;Aschach an der Donau;2021;1849;131;173;7;49;2209
AT31;40503;Eferding;2021;3385;297;446;26;117;4271
AT31;40504;Fraham;2021;2250;105;81;2;16;2454
AT31;40505;Haibach ob der Donau;2021;1254;26;1;0;7;1288
AT31;40506;Hartkirchen;2021;3861;58;62;5;20;4006
AT31;40507;Hinzenbach;2021;1927;63;71;2;15;2078
AT31;40508;Prambachkirchen;2021;2774;139;35;4;21;2973
AT31;40509;Pupping;2021;1698;44;48;3;13;1806
AT31;40510;St. Marienkirchen an der Polsenz;2021;2229;60;15;10;13;2327
AT31;40511;Scharten;2021;2176;60;37;1;8;2282
AT31;40512;Stroheim;2021;1600;18;0;1;5;1624
AT31;40601;Freistadt;2021;7151;257;51;266;247;7972
AT31;40602;Grünbach;2021;1836;24;0;3;21;1884
AT31;40603;Gutau;2021;2663;48;3;1;11;2726
AT31;40604;Hagenberg im Mühlkreis;2021;2707;73;3;2;29;2814
AT31;40605;Hirschbach im Mühlkreis;2021;1151;16;0;0;2;1169
AT31;40606;Kaltenberg;2021;599;6;0;0;0;605
AT31;40607;Kefermarkt;2021;2087;70;3;1;15;2176
AT31;40608;Königswiesen;2021;3058;21;1;0;3;3083
AT31;40609;Lasberg;2021;2795;73;2;12;19;2901
AT31;40610;Leopoldschlag;2021;952;30;0;8;2;992
AT31;40611;Liebenau;2021;1559;11;1;0;4;1575
AT31;40612;Neumarkt im Mühlkreis;2021;3084;56;1;4;30;3175
AT31;40613;Pierbach;2021;1011;8;0;0;6;1025
AT31;40614;Pregarten;2021;5241;207;38;5;74;5565
AT31;40615;Rainbach im Mühlkreis;2021;2861;67;2;17;56;3003
AT31;40616;Sandl;2021;1328;38;0;0;1;1367
AT31;40617;St. Leonhard bei Freistadt;2021;1333;18;0;0;3;1354
AT31;40618;St. Oswald bei Freistadt;2021;2832;66;6;4;14;2922
AT31;40619;Schönau im Mühlkreis;2021;1932;18;0;0;2;1952
AT31;40620;Tragwein;2021;3038;61;8;0;26;3133
AT31;40621;Unterweißenbach;2021;2112;17;0;5;2;2136
AT31;40622;Unterweitersdorf;2021;2139;32;4;2;10;2187
AT31;40623;Waldburg;2021;1402;13;0;1;9;1425
AT31;40624;Wartberg ob der Aist;2021;4288;76;6;2;33;4405
AT31;40625;Weitersfelden;2021;1008;38;0;0;2;1048
AT31;40626;Windhaag bei Freistadt;2021;1545;16;2;29;1;1593
AT31;40627;Bad Zell;2021;2907;34;17;6;12;2976
AT31;40701;Altmünster;2021;9042;591;89;12;123;9857
AT31;40702;Bad Goisern am Hallstättersee;2021;7055;373;18;8;74;7528
AT31;40703;Bad Ischl;2021;12192;1199;174;179;318;14062
AT31;40704;Ebensee am Traunsee;2021;6956;390;94;4;71;7515
AT31;40705;Gmunden;2021;10743;1458;620;71;359;13251
AT31;40706;Gosau;2021;1651;143;5;0;21;1820
AT31;40707;Grünau im Almtal;2021;1864;116;10;12;21;2023
AT31;40708;Gschwandt;2021;2800;93;22;2;20;2937
AT31;40709;Hallstatt;2021;615;86;10;0;14;725
AT31;40710;Kirchham;2021;2120;72;10;14;11;2227
AT31;40711;Laakirchen;2021;8178;659;778;57;118;9790
AT31;40712;Obertraun;2021;611;92;0;0;31;734
AT31;40713;Ohlsdorf;2021;4923;205;104;13;128;5373
AT31;40714;Pinsdorf;2021;3590;356;153;13;42;4154
AT31;40715;Roitham am Traunfall;2021;1958;97;4;5;19;2083
AT31;40716;St. Konrad;2021;1116;44;1;0;7;1168
AT31;40717;St. Wolfgang im Salzkammergut;2021;2565;192;52;2;37;2848
AT31;40718;Traunkirchen;2021;1562;81;9;8;20;1680
AT31;40719;Scharnstein;2021;4542;294;61;25;36;4958
AT31;40720;Vorchdorf;2021;6910;312;165;144;71;7602
AT31;40801;Aistersheim;2021;874;72;10;0;8;964
AT31;40802;Bad Schallerbach;2021;3549;506;187;22;64;4328
AT31;40804;Eschenau im Hausruckkreis;2021;1034;14;0;0;3;1051
AT31;40805;Gallspach;2021;2110;419;207;57;31;2824
AT31;40806;Gaspoltshofen;2021;3316;213;42;20;31;3622
AT31;40807;Geboltskirchen;2021;1374;70;2;1;12;1459
AT31;40808;Grieskirchen;2021;4012;361;231;272;153;5029
AT31;40809;Haag am Hausruck;2021;1978;152;70;9;46;2255
AT31;40810;Heiligenberg;2021;681;18;0;0;0;699
AT31;40811;Hofkirchen an der Trattnach;2021;1515;101;53;1;15;1685
AT31;40812;Kallham;2021;2348;70;15;16;10;2459
AT31;40813;Kematen am Innbach;2021;1317;71;15;22;10;1435
AT31;40814;Meggenhofen;2021;1501;38;0;3;22;1564
AT31;40815;Michaelnbach;2021;1241;38;0;0;9;1288
AT31;40816;Natternbach;2021;2211;58;0;0;23;2292
AT31;40817;Neukirchen am Walde;2021;1588;36;2;0;7;1633
AT31;40818;Neumarkt im Hausruckkreis;2021;1237;105;34;84;9;1469
AT31;40820;Pötting;2021;553;3;0;0;0;556
AT31;40821;Pollham;2021;948;16;0;0;10;974
AT31;40822;Pram;2021;1625;93;9;0;8;1735
AT31;40823;Rottenbach;2021;1022;59;20;0;5;1106
AT31;40824;St. Agatha;2021;2087;39;0;0;6;2132
AT31;40825;St. Georgen bei Grieskirchen;2021;1291;25;2;7;7;1332
AT31;40826;St. Thomas;2021;560;14;0;0;0;574
AT31;40827;Schlüßlberg;2021;2782;121;51;60;19;3033
AT31;40828;Steegen;2021;1059;11;10;0;6;1086
AT31;40829;Taufkirchen an der Trattnach;2021;1881;76;9;0;6;1972
AT31;40830;Tollet;2021;907;24;1;0;4;936
AT31;40831;Waizenkirchen;2021;3478;169;90;25;32;3794
AT31;40832;Wallern an der Trattnach;2021;2865;166;33;25;21;3110
AT31;40833;Weibern;2021;1560;81;58;1;12;1712
AT31;40834;Wendling;2021;864;7;0;6;1;878
AT31;40835;Peuerbach;2021;4328;207;47;40;52;4674
AT31;40901;Edlbach;2021;581;32;8;0;19;640
AT31;40902;Grünburg;2021;3478;166;79;112;49;3884
AT31;40903;Hinterstoder;2021;784;94;3;0;18;899
AT31;40904;Inzersdorf im Kremstal;2021;1802;64;11;10;17;1904
AT31;40905;Kirchdorf an der Krems;2021;3818;480;203;98;112;4711
AT31;40906;Klaus an der Pyhrnbahn;2021;952;95;3;0;14;1064
AT31;40907;Kremsmünster;2021;5464;874;273;21;78;6710
AT31;40908;Micheldorf in Oberösterreich;2021;5350;304;173;71;62;5960
AT31;40909;Molln;2021;3270;121;70;115;60;3636
AT31;40910;Nußbach;2021;2206;69;3;0;9;2287
AT31;40911;Oberschlierbach;2021;470;15;1;0;2;488
AT31;40912;Pettenbach;2021;4926;262;53;88;61;5390
AT31;40913;Ried im Traunkreis;2021;2673;173;28;17;12;2903
AT31;40914;Rosenau am Hengstpaß;2021;576;58;20;0;4;658
AT31;40915;Roßleithen;2021;1790;53;21;0;10;1874
AT31;40916;St. Pankraz;2021;329;15;4;0;9;357
AT31;40917;Schlierbach;2021;2640;140;40;8;70;2898
AT31;40918;Spital am Pyhrn;2021;2058;134;29;1;23;2245
AT31;40919;Steinbach am Ziehberg;2021;841;18;2;0;2;863
AT31;40920;Steinbach an der Steyr;2021;1867;70;11;4;16;1968
AT31;40921;Vorderstoder;2021;776;34;0;0;9;819
AT31;40922;Wartberg an der Krems;2021;2678;157;42;27;46;2950
AT31;40923;Windischgarsten;2021;2092;188;72;2;43;2397
AT31;41001;Allhaming;2021;1132;96;3;10;7;1248
AT31;41002;Ansfelden;2021;13060;2289;1082;537;780;17748
AT31;41003;Asten;2021;5602;647;282;131;160;6822
AT31;41004;Eggendorf im Traunkreis;2021;1039;69;4;4;2;1118
AT31;41005;Enns;2021;9076;1635;866;225;223;12025
AT31;41006;Hargelsberg;2021;1363;55;3;1;4;1426
AT31;41007;Hörsching;2021;5456;664;140;62;64;6386
AT31;41008;Hofkirchen im Traunkreis;2021;1871;160;3;0;6;2040
AT31;41009;Kematen an der Krems;2021;2697;202;51;24;77;3051
AT31;41010;Kirchberg-Thening;2021;2441;90;9;11;18;2569
AT31;41011;Kronstorf;2021;3142;281;117;13;20;3573
AT31;41012;Leonding;2021;24426;2414;804;279;1044;28967
AT31;41013;St. Florian;2021;5936;255;35;4;48;6278
AT31;41014;Neuhofen an der Krems;2021;5996;412;176;31;132;6747
AT31;41015;Niederneukirchen;2021;2040;60;13;0;7;2120
AT31;41016;Oftering;2021;2014;71;24;4;9;2122
AT31;41017;Pasching;2021;6455;648;225;156;203;7687
AT31;41018;Piberbach;2021;1758;69;15;13;14;1869
AT31;41019;Pucking;2021;3825;197;65;39;28;4154
AT31;41020;St. Marien;2021;4548;243;47;17;48;4903
AT31;41021;Traun;2021;18226;3202;1993;663;842;24926
AT31;41022;Wilhering;2021;5415;261;63;8;85;5832
AT31;41101;Allerheiligen im Mühlkreis;2021;1231;11;0;0;14;1256
AT31;41102;Arbing;2021;1456;75;9;6;7;1553
AT31;41103;Baumgartenberg;2021;1684;82;7;8;24;1805
AT31;41104;Dimbach;2021;959;8;0;0;2;969
AT31;41105;Grein;2021;2625;196;18;1;73;2913
AT31;41106;Katsdorf;2021;3086;120;3;0;35;3244
AT31;41107;Klam;2021;922;32;0;1;0;955
AT31;41108;Bad Kreuzen;2021;2129;25;7;8;144;2313
AT31;41109;Langenstein;2021;2271;154;17;37;56;2535
AT31;41110;Luftenberg an der Donau;2021;4051;214;48;13;36;4362
AT31;41111;Mauthausen;2021;4070;438;138;221;84;4951
AT31;41112;Mitterkirchen im Machland;2021;1646;83;12;8;22;1771
AT31;41113;Münzbach;2021;1675;130;14;2;28;1849
AT31;41114;Naarn im Machlande;2021;3383;143;53;70;56;3705
AT31;41115;Pabneukirchen;2021;1627;20;12;0;20;1679
AT31;41116;Perg;2021;7517;722;323;282;160;9004
AT31;41117;Rechberg;2021;975;36;1;0;5;1017
AT31;41118;Ried in der Riedmark;2021;4185;90;5;8;13;4301
AT31;41119;St. Georgen am Walde;2021;1956;13;0;0;4;1973
AT31;41120;St. Georgen an der Gusen;2021;3979;220;42;59;151;4451
AT31;41121;St. Nikola an der Donau;2021;628;52;6;5;131;822
AT31;41122;St. Thomas am Blasenstein;2021;906;16;3;0;3;928
AT31;41123;Saxen;2021;1611;72;5;4;31;1723
AT31;41124;Schwertberg;2021;4608;505;67;133;59;5372
AT31;41125;Waldhausen im Strudengau;2021;2721;60;8;8;54;2851
AT31;41126;Windhaag bei Perg;2021;1364;120;28;7;6;1525
AT31;41201;Andrichsfurt;2021;728;58;1;0;3;790
AT31;41202;Antiesenhofen;2021;898;137;26;6;2;1069
AT31;41203;Aurolzmünster;2021;2586;317;128;86;24;3141
AT31;41204;Eberschwang;2021;3174;174;68;4;24;3444
AT31;41205;Eitzing;2021;821;41;3;7;3;875
AT31;41206;Geiersberg;2021;488;13;4;0;0;505
AT31;41207;Geinberg;2021;1222;179;20;7;10;1438
AT31;41208;Gurten;2021;1072;88;13;1;16;1190
AT31;41209;Hohenzell;2021;2161;74;41;3;9;2288
AT31;41210;Kirchdorf am Inn;2021;564;73;0;2;2;641
AT31;41211;Kirchheim im Innkreis;2021;724;23;3;0;3;753
AT31;41212;Lambrechten;2021;1237;48;6;0;6;1297
AT31;41213;Lohnsburg am Kobernaußerwald;2021;2100;90;0;0;6;2196
AT31;41214;Mehrnbach;2021;2146;81;51;11;56;2345
AT31;41215;Mettmach;2021;2274;107;0;1;7;2389
AT31;41216;Mörschwang;2021;310;26;0;0;0;336
AT31;41217;Mühlheim am Inn;2021;603;65;2;0;9;679
AT31;41218;Neuhofen im Innkreis;2021;2287;111;53;16;31;2498
AT31;41219;Obernberg am Inn;2021;1185;426;27;3;14;1655
AT31;41220;Ort im Innkreis;2021;1152;121;12;35;12;1332
AT31;41221;Pattigham;2021;983;45;13;0;11;1052
AT31;41222;Peterskirchen;2021;646;14;0;0;0;660
AT31;41223;Pramet;2021;975;31;5;0;2;1013
AT31;41224;Reichersberg;2021;1359;171;31;5;34;1600
AT31;41225;Ried im Innkreis;2021;9261;1460;573;555;583;12432
AT31;41226;St. Georgen bei Obernberg am Inn;2021;493;42;3;0;7;545
AT31;41227;St. Marienkirchen am Hausruck;2021;874;18;8;2;3;905
AT31;41228;St. Martin im Innkreis;2021;1636;364;88;12;32;2132
AT31;41229;Schildorn;2021;1174;33;1;0;12;1220
AT31;41230;Senftenbach;2021;710;56;8;9;3;786
AT31;41231;Taiskirchen im Innkreis;2021;2293;90;2;4;11;2400
AT31;41232;Tumeltsham;2021;1467;51;34;13;10;1575
AT31;41233;Utzenaich;2021;1490;105;17;6;4;1622
AT31;41234;Waldzell;2021;2174;70;1;5;27;2277
AT31;41235;Weilbach;2021;566;45;0;0;2;613
AT31;41236;Wippenham;2021;537;17;0;1;4;559
AT31;41304;Altenfelden;2021;2155;29;13;10;80;2287
AT31;41305;Arnreit;2021;1132;6;12;0;15;1165
AT31;41306;Atzesberg;2021;432;4;0;0;1;437
AT31;41307;Auberg;2021;581;9;0;0;2;592
AT31;41309;Haslach an der Mühl;2021;2379;94;16;10;80;2579
AT31;41311;Hörbich;2021;386;5;1;0;16;408
AT31;41312;Hofkirchen im Mühlkreis;2021;1458;66;1;0;4;1529
AT31;41313;Julbach;2021;1483;56;0;0;5;1544
AT31;41314;Kirchberg ob der Donau;2021;1033;17;0;0;7;1057
AT31;41315;Klaffer am Hochficht;2021;1204;59;0;1;47;1311
AT31;41316;Kleinzell im Mühlkreis;2021;1664;24;0;9;8;1705
AT31;41317;Kollerschlag;2021;1476;54;0;2;9;1541
AT31;41318;Lembach im Mühlkreis;2021;1410;42;24;2;37;1515
AT31;41319;Lichtenau im Mühlkreis;2021;465;5;0;0;3;473
AT31;41320;Nebelberg;2021;623;27;0;0;2;652
AT31;41321;Neufelden;2021;1041;41;37;0;104;1223
AT31;41322;Niederkappel;2021;957;18;0;0;2;977
AT31;41323;Niederwaldkirchen;2021;1800;35;0;5;13;1853
AT31;41324;Oberkappel;2021;627;61;0;0;14;702
AT31;41325;Oepping;2021;1508;29;2;0;1;1540
AT31;41326;Peilstein im Mühlviertel;2021;1513;34;1;0;8;1556
AT31;41327;Pfarrkirchen im Mühlkreis;2021;1340;64;0;0;17;1421
AT31;41328;Putzleinsdorf;2021;1466;26;15;1;15;1523
AT31;41329;Neustift im Mühlkreis;2021;1387;63;0;0;27;1477
AT31;41331;St. Johann am Wimberg;2021;972;28;1;2;3;1006
AT31;41332;St. Martin im Mühlkreis;2021;3578;68;5;29;45;3725
AT31;41333;St. Oswald bei Haslach;2021;492;14;1;0;0;507
AT31;41334;St. Peter am Wimberg;2021;1696;21;0;0;6;1723
AT31;41336;St. Ulrich im Mühlkreis;2021;667;16;0;0;1;684
AT31;41337;St. Veit im Mühlkreis;2021;1265;27;6;0;13;1311
AT31;41338;Sarleinsbach;2021;2195;37;3;1;9;2245
AT31;41341;Schwarzenberg am Böhmerwald;2021;501;74;0;0;2;577
AT31;41342;Ulrichsberg;2021;2684;143;0;0;38;2865
AT31;41343;Aigen-Schlägl;2021;3017;138;30;0;35;3220
AT31;41344;Rohrbach-Berg;2021;4764;189;45;27;216;5241
AT31;41345;Helfenberg;2021;1447;51;6;6;34;1544
AT31;41346;St. Stefan-Afiesl;2021;1079;38;1;0;5;1123
AT31;41401;Altschwendt;2021;678;15;0;2;23;718
AT31;41402;Andorf;2021;4783;194;62;85;63;5187
AT31;41403;Brunnenthal;2021;1871;180;16;9;24;2100
AT31;41404;Diersbach;2021;1462;48;0;1;21;1532
AT31;41405;Dorf an der Pram;2021;1037;30;2;4;4;1077
AT31;41406;Eggerding;2021;1287;55;9;6;4;1361
AT31;41407;Engelhartszell;2021;831;78;3;1;9;922
AT31;41408;Enzenkirchen;2021;1708;78;2;1;9;1798
AT31;41409;Esternberg;2021;2668;177;0;1;5;2851
AT31;41410;Freinberg;2021;1034;374;0;0;13;1421
AT31;41411;Kopfing im Innkreis;2021;1896;63;0;0;15;1974
AT31;41412;Mayrhof;2021;309;7;0;0;1;317
AT31;41413;Münzkirchen;2021;2474;80;3;0;7;2564
AT31;41414;Raab;2021;2127;104;1;15;24;2271
AT31;41415;Rainbach im Innkreis;2021;1478;39;0;11;6;1534
AT31;41416;Riedau;2021;1831;132;20;42;31;2056
AT31;41417;St. Aegidi;2021;1499;29;0;0;9;1537
AT31;41418;St. Florian am Inn;2021;2734;275;15;70;48;3142
AT31;41419;St. Marienkirchen bei Schärding;2021;1787;123;15;30;11;1966
AT31;41420;St. Roman;2021;1718;37;0;0;0;1755
AT31;41421;St. Willibald;2021;1068;44;4;0;2;1118
AT31;41422;Schärding;2021;3949;674;165;174;253;5215
AT31;41423;Schardenberg;2021;2040;392;8;0;20;2460
AT31;41424;Sigharting;2021;804;29;0;5;5;843
AT31;41425;Suben;2021;1242;131;42;43;83;1541
AT31;41426;Taufkirchen an der Pram;2021;2649;125;6;56;54;2890
AT31;41427;Vichtenstein;2021;516;98;1;0;5;620
AT31;41428;Waldkirchen am Wesen;2021;1131;38;0;0;4;1173
AT31;41429;Wernstein am Inn;2021;1365;161;2;2;17;1547
AT31;41430;Zell an der Pram;2021;1863;98;5;29;12;2007
AT31;41501;Adlwang;2021;1858;62;10;5;29;1964
AT31;41502;Aschach an der Steyr;2021;2226;28;13;0;15;2282
AT31;41503;Bad Hall;2021;4844;467;108;91;145;5655
AT31;41504;Dietach;2021;3053;149;76;17;33;3328
AT31;41505;Gaflenz;2021;1869;64;7;0;9;1949
AT31;41506;Garsten;2021;6241;205;47;20;132;6645
AT31;41507;Großraming;2021;2580;56;3;0;13;2652
AT31;41508;Laussa;2021;1199;20;1;0;2;1222
AT31;41509;Losenstein;2021;1531;84;7;0;16;1638
AT31;41510;Maria Neustift;2021;1614;19;0;0;9;1642
AT31;41511;Pfarrkirchen bei Bad Hall;2021;2157;122;16;5;29;2329
AT31;41512;Reichraming;2021;1601;61;4;0;17;1683
AT31;41513;Rohr im Kremstal;2021;1348;61;33;12;5;1459
AT31;41514;St. Ulrich bei Steyr;2021;2970;77;26;1;24;3098
AT31;41515;Schiedlberg;2021;1243;58;9;1;5;1316
AT31;41516;Sierning;2021;8498;489;242;107;115;9451
AT31;41517;Ternberg;2021;3192;112;0;3;60;3367
AT31;41518;Waldneukirchen;2021;2100;64;19;17;7;2207
AT31;41521;Wolfern;2021;3190;76;8;3;8;3285
AT31;41522;Weyer;2021;3718;163;20;7;129;4037
AT31;41601;Alberndorf in der Riedmark;2021;4074;89;8;0;27;4198
AT31;41602;Altenberg bei Linz;2021;4532;116;2;0;46;4696
AT31;41603;Bad Leonfelden;2021;3998;181;28;22;68;4297
AT31;41604;Eidenberg;2021;2008;61;0;1;20;2090
AT31;41605;Engerwitzdorf;2021;8611;265;40;2;136;9054
AT31;41606;Feldkirchen an der Donau;2021;5170;107;76;15;58;5426
AT31;41607;Gallneukirchen;2021;6096;290;71;25;141;6623
AT31;41608;Goldwörth;2021;761;6;2;0;14;783
AT31;41609;Gramastetten;2021;4860;166;8;13;75;5122
AT31;41610;Haibach im Mühlkreis;2021;897;38;0;0;2;937
AT31;41611;Hellmonsödt;2021;2209;94;14;11;36;2364
AT31;41612;Herzogsdorf;2021;2651;45;0;1;8;2705
AT31;41613;Kirchschlag bei Linz;2021;2064;105;9;0;33;2211
AT31;41614;Lichtenberg;2021;2742;65;0;3;34;2844
AT31;41615;Oberneukirchen;2021;3024;70;9;2;36;3141
AT31;41616;Ottenschlag im Mühlkreis;2021;548;12;1;0;3;564
AT31;41617;Ottensheim;2021;4373;209;44;15;159;4800
AT31;41618;Puchenau;2021;4234;225;21;5;75;4560
AT31;41619;Reichenau im Mühlkreis;2021;1262;62;0;0;11;1335
AT31;41620;Reichenthal;2021;1451;28;3;1;9;1492
AT31;41621;St. Gotthard im Mühlkreis;2021;1243;60;0;0;32;1335
AT31;41622;Schenkenfelden;2021;1569;15;3;0;29;1616
AT31;41623;Sonnberg im Mühlkreis;2021;1060;30;0;0;4;1094
AT31;41624;Steyregg;2021;4519;277;77;8;239;5120
AT31;41626;Walding;2021;4046;117;16;11;83;4273
AT31;41627;Zwettl an der Rodl;2021;1642;46;1;8;36;1733
AT31;41628;Vorderweißenbach;2021;2650;51;3;5;5;2714
AT31;41701;Ampflwang im Hausruckwald;2021;2880;396;48;23;42;3389
AT31;41702;Attersee am Attersee;2021;1504;104;3;0;19;1630
AT31;41703;Attnang-Puchheim;2021;6350;1394;725;334;304;9107
AT31;41704;Atzbach;2021;1163;77;0;0;5;1245
AT31;41705;Aurach am Hongar;2021;1762;40;6;3;7;1818
AT31;41706;Berg im Attergau;2021;1068;41;0;0;5;1114
AT31;41707;Desselbrunn;2021;1791;81;16;1;8;1897
AT31;41708;Fornach;2021;948;42;0;0;3;993
AT31;41709;Frankenburg am Hausruck;2021;4586;271;56;9;253;5175
AT31;41710;Frankenmarkt;2021;3115;475;103;42;63;3798
AT31;41711;Gampern;2021;2909;105;19;0;13;3046
AT31;41712;Innerschwand am Mondsee;2021;1142;81;5;0;7;1235
AT31;41713;Lenzing;2021;4494;436;180;25;110;5245
AT31;41714;Manning;2021;783;8;0;0;8;799
AT31;41715;Mondsee;2021;3033;635;158;20;234;4080
AT31;41716;Neukirchen an der Vöckla;2021;2525;90;11;0;7;2633
AT31;41717;Niederthalheim;2021;1025;65;8;14;14;1126
AT31;41718;Nußdorf am Attersee;2021;1020;77;13;2;19;1131
AT31;41719;Oberhofen am Irrsee;2021;1552;124;15;0;7;1698
AT31;41720;Oberndorf bei Schwanenstadt;2021;1225;69;35;3;34;1366
AT31;41721;Oberwang;2021;1690;56;2;0;3;1751
AT31;41722;Ottnang am Hausruck;2021;3572;280;16;5;25;3898
AT31;41723;Pfaffing;2021;1489;41;1;0;17;1548
AT31;41724;Pilsbach;2021;621;25;5;1;2;654
AT31;41725;Pitzenberg;2021;547;17;0;0;7;571
AT31;41726;Pöndorf;2021;2245;146;14;11;6;2422
AT31;41727;Puchkirchen am Trattberg;2021;1023;63;8;0;4;1098
AT31;41728;Pühret;2021;615;9;11;5;0;640
AT31;41729;Redleiten;2021;505;17;0;2;9;533
AT31;41730;Redlham;2021;1518;81;24;2;10;1635
AT31;41731;Regau;2021;6050;445;194;16;131;6836
AT31;41732;Rüstorf;2021;2060;126;73;13;12;2284
AT31;41733;Rutzenham;2021;281;6;4;0;0;291
AT31;41734;St. Georgen im Attergau;2021;3850;345;142;26;113;4476
AT31;41735;St. Lorenz;2021;2289;184;13;11;28;2525
AT31;41736;Schlatt;2021;1287;103;23;10;7;1430
AT31;41737;Schörfling am Attersee;2021;3150;234;42;0;27;3453
AT31;41738;Schwanenstadt;2021;3543;553;295;65;152;4608
AT31;41739;Seewalchen am Attersee;2021;5303;274;54;6;55;5692
AT31;41740;Steinbach am Attersee;2021;800;91;0;0;12;903
AT31;41741;Straß im Attergau;2021;1408;96;14;3;11;1532
AT31;41742;Tiefgraben;2021;3636;319;36;6;48;4045
AT31;41743;Timelkam;2021;5173;351;218;38;191;5971
AT31;41744;Ungenach;2021;1410;62;3;1;10;1486
AT31;41745;Unterach am Attersee;2021;1353;127;34;2;25;1541
AT31;41746;Vöcklabruck;2021;9910;1024;602;108;874;12518
AT31;41747;Vöcklamarkt;2021;4481;344;161;55;105;5146
AT31;41748;Weißenkirchen im Attergau;2021;932;36;0;0;0;968
AT31;41749;Weyregg am Attersee;2021;1474;73;5;0;10;1562
AT31;41750;Wolfsegg am Hausruck;2021;1771;187;1;4;38;2001
AT31;41751;Zell am Moos;2021;1494;96;12;10;40;1652
AT31;41752;Zell am Pettenfirst;2021;1154;48;3;1;15;1221
AT31;41801;Aichkirchen;2021;596;26;6;3;4;635
AT31;41802;Bachmanning;2021;627;77;7;11;2;724
AT31;41803;Bad Wimsbach-Neydharting;2021;2385;89;28;24;23;2549
AT31;41804;Buchkirchen;2021;3822;118;25;19;17;4001
AT31;41805;Eberstalzell;2021;2649;108;54;5;35;2851
AT31;41806;Edt bei Lambach;2021;2120;149;47;6;20;2342
AT31;41807;Fischlham;2021;1298;36;1;2;3;1340
AT31;41808;Gunskirchen;2021;5648;592;144;16;31;6431
AT31;41809;Holzhausen;2021;958;56;3;1;2;1020
AT31;41810;Krenglbach;2021;2995;164;17;14;19;3209
AT31;41811;Lambach;2021;2853;477;284;30;98;3742
AT31;41812;Marchtrenk;2021;11906;1535;453;266;276;14436
AT31;41813;Neukirchen bei Lambach;2021;897;46;3;3;10;959
AT31;41814;Offenhausen;2021;1538;135;13;22;7;1715
AT31;41815;Pennewang;2021;901;55;0;0;1;957
AT31;41816;Pichl bei Wels;2021;2671;188;33;49;23;2964
AT31;41817;Sattledt;2021;2293;241;61;66;32;2693
AT31;41818;Schleißheim;2021;1313;76;3;8;11;1411
AT31;41819;Sipbachzell;2021;2059;106;12;8;26;2211
AT31;41820;Stadl-Paura;2021;4099;429;353;64;71;5016
AT31;41821;Steinerkirchen an der Traun;2021;2325;91;14;0;19;2449
AT31;41822;Steinhaus;2021;2320;141;18;0;24;2503
AT31;41823;Thalheim bei Wels;2021;4742;509;139;45;76;5511
AT31;41824;Weißkirchen an der Traun;2021;3233;209;50;17;61;3570
AT31;40101;Linz;2020;154259;21249;12136;3552;15341;206537
AT31;40201;Steyr;2020;30249;2988;2340;937;1438;37952
AT31;40301;Wels;2020;44512;7740;5846;1670;2886;62654
AT31;40401;Altheim;2020;4265;513;157;14;40;4989
AT31;40402;Aspach;2020;2348;226;16;1;13;2604
AT31;40403;Auerbach;2020;624;50;37;0;7;718
AT31;40404;Braunau am Inn;2020;12735;2398;1205;152;948;17438
AT31;40405;Burgkirchen;2020;2425;235;70;0;13;2743
AT31;40406;Eggelsberg;2020;2274;214;27;7;22;2544
AT31;40407;Feldkirchen bei Mattighofen;2020;1895;96;11;2;13;2017
AT31;40408;Franking;2020;897;113;5;0;3;1018
AT31;40409;Geretsberg;2020;1072;85;2;0;12;1171
AT31;40410;Gilgenberg am Weilhart;2020;1220;131;7;0;13;1371
AT31;40411;Haigermoos;2020;587;34;0;0;2;623
AT31;40412;Handenberg;2020;1243;73;9;0;3;1328
AT31;40413;Helpfau-Uttendorf;2020;2806;599;234;19;39;3697
AT31;40414;Hochburg-Ach;2020;2511;769;17;1;40;3338
AT31;40415;Höhnhart;2020;1346;84;0;0;13;1443
AT31;40416;Jeging;2020;590;63;6;22;5;686
AT31;40417;Kirchberg bei Mattighofen;2020;1131;56;1;11;5;1204
AT31;40418;Lengau;2020;4294;368;150;49;36;4897
AT31;40419;Lochen am See;2020;2719;133;7;9;4;2872
AT31;40420;Maria Schmolln;2020;1355;60;0;1;20;1436
AT31;40421;Mattighofen;2020;4463;1250;1055;148;182;7098
AT31;40422;Mauerkirchen;2020;1910;370;226;0;33;2539
AT31;40423;Mining;2020;1173;74;3;2;12;1264
AT31;40424;Moosbach;2020;926;143;19;0;14;1102
AT31;40425;Moosdorf;2020;1520;160;10;0;16;1706
AT31;40426;Munderfing;2020;2688;259;91;23;31;3092
AT31;40427;Neukirchen an der Enknach;2020;2060;141;33;3;41;2278
AT31;40428;Ostermiething;2020;2834;345;70;9;26;3284
AT31;40429;Palting;2020;1005;33;7;0;10;1055
AT31;40430;Perwang am Grabensee;2020;989;75;2;0;7;1073
AT31;40431;Pfaffstätt;2020;931;204;40;1;5;1181
AT31;40432;Pischelsdorf am Engelbach;2020;1509;157;13;2;20;1701
AT31;40433;Polling im Innkreis;2020;924;51;7;0;6;988
AT31;40434;Roßbach;2020;845;44;0;0;4;893
AT31;40435;St. Georgen am Fillmannsbach;2020;413;17;0;0;0;430
AT31;40436;St. Johann am Walde;2020;1900;132;3;1;7;2043
AT31;40437;St. Pantaleon;2020;2697;310;130;10;61;3208
AT31;40438;St. Peter am Hart;2020;2093;258;11;15;50;2427
AT31;40439;St. Radegund;2020;532;74;3;0;1;610
AT31;40440;St. Veit im Innkreis;2020;384;27;0;0;1;412
AT31;40441;Schalchen;2020;3369;341;258;17;30;4015
AT31;40442;Schwand im Innkreis;2020;935;56;0;0;9;1000
AT31;40443;Tarsdorf;2020;1899;188;19;1;6;2113
AT31;40444;Treubach;2020;664;63;4;0;6;737
AT31;40445;Überackern;2020;480;198;0;0;3;681
AT31;40446;Weng im Innkreis;2020;1328;64;10;0;23;1425
AT31;40501;Alkoven;2020;5556;261;111;28;112;6068
AT31;40502;Aschach an der Donau;2020;1841;130;172;6;42;2191
AT31;40503;Eferding;2020;3411;240;438;25;162;4276
AT31;40504;Fraham;2020;2254;104;77;2;19;2456
AT31;40505;Haibach ob der Donau;2020;1246;17;1;0;7;1271
AT31;40506;Hartkirchen;2020;3895;59;59;5;24;4042
AT31;40507;Hinzenbach;2020;1921;57;68;2;14;2062
AT31;40508;Prambachkirchen;2020;2762;130;43;4;23;2962
AT31;40509;Pupping;2020;1697;37;53;3;16;1806
AT31;40510;St. Marienkirchen an der Polsenz;2020;2240;64;13;10;8;2335
AT31;40511;Scharten;2020;2175;62;26;1;10;2274
AT31;40512;Stroheim;2020;1603;18;0;1;3;1625
AT31;40601;Freistadt;2020;7150;249;45;259;256;7959
AT31;40602;Grünbach;2020;1877;26;0;2;22;1927
AT31;40603;Gutau;2020;2675;53;3;0;21;2752
AT31;40604;Hagenberg im Mühlkreis;2020;2684;78;3;1;29;2795
AT31;40605;Hirschbach im Mühlkreis;2020;1156;17;0;0;4;1177
AT31;40606;Kaltenberg;2020;603;7;0;0;0;610
AT31;40607;Kefermarkt;2020;2087;52;4;0;15;2158
AT31;40608;Königswiesen;2020;3059;22;1;0;6;3088
AT31;40609;Lasberg;2020;2731;51;8;12;30;2832
AT31;40610;Leopoldschlag;2020;955;31;0;8;4;998
AT31;40611;Liebenau;2020;1546;9;1;0;3;1559
AT31;40612;Neumarkt im Mühlkreis;2020;3062;53;1;4;20;3140
AT31;40613;Pierbach;2020;1003;8;2;0;6;1019
AT31;40614;Pregarten;2020;5244;187;39;6;70;5546
AT31;40615;Rainbach im Mühlkreis;2020;2859;64;1;18;23;2965
AT31;40616;Sandl;2020;1333;36;0;3;7;1379
AT31;40617;St. Leonhard bei Freistadt;2020;1329;17;0;0;2;1348
AT31;40618;St. Oswald bei Freistadt;2020;2828;66;6;4;6;2910
AT31;40619;Schönau im Mühlkreis;2020;1934;20;0;0;3;1957
AT31;40620;Tragwein;2020;3045;51;9;0;26;3131
AT31;40621;Unterweißenbach;2020;2119;18;0;5;7;2149
AT31;40622;Unterweitersdorf;2020;2140;32;4;3;11;2190
AT31;40623;Waldburg;2020;1387;16;0;0;9;1412
AT31;40624;Wartberg ob der Aist;2020;4236;87;5;2;31;4361
AT31;40625;Weitersfelden;2020;1017;36;0;0;2;1055
AT31;40626;Windhaag bei Freistadt;2020;1521;19;1;29;1;1571
AT31;40627;Bad Zell;2020;2877;26;17;5;9;2934
AT31;40701;Altmünster;2020;9078;573;84;11;119;9865
AT31;40702;Bad Goisern am Hallstättersee;2020;7043;387;19;6;73;7528
AT31;40703;Bad Ischl;2020;12235;1183;174;180;337;14109
AT31;40704;Ebensee am Traunsee;2020;7028;398;97;5;69;7597
AT31;40705;Gmunden;2020;10815;1368;612;71;337;13203
AT31;40706;Gosau;2020;1663;135;3;0;21;1822
AT31;40707;Grünau im Almtal;2020;1875;122;12;13;23;2045
AT31;40708;Gschwandt;2020;2749;90;20;2;19;2880
AT31;40709;Hallstatt;2020;620;98;13;0;15;746
AT31;40710;Kirchham;2020;2130;72;10;15;11;2238
AT31;40711;Laakirchen;2020;8198;603;769;55;118;9743
AT31;40712;Obertraun;2020;616;95;0;0;32;743
AT31;40713;Ohlsdorf;2020;4938;205;106;18;19;5286
AT31;40714;Pinsdorf;2020;3550;318;156;11;48;4083
AT31;40715;Roitham am Traunfall;2020;1928;97;5;5;16;2051
AT31;40716;St. Konrad;2020;1100;50;1;0;7;1158
AT31;40717;St. Wolfgang im Salzkammergut;2020;2548;202;54;2;29;2835
AT31;40718;Traunkirchen;2020;1544;76;8;4;19;1651
AT31;40719;Scharnstein;2020;4554;270;60;26;37;4947
AT31;40720;Vorchdorf;2020;6865;331;173;143;60;7572
AT31;40801;Aistersheim;2020;877;60;11;0;5;953
AT31;40802;Bad Schallerbach;2020;3463;487;189;17;53;4209
AT31;40804;Eschenau im Hausruckkreis;2020;1030;14;0;0;3;1047
AT31;40805;Gallspach;2020;2141;355;203;68;42;2809
AT31;40806;Gaspoltshofen;2020;3290;201;37;21;31;3580
AT31;40807;Geboltskirchen;2020;1373;54;2;0;11;1440
AT31;40808;Grieskirchen;2020;3999;350;211;269;155;4984
AT31;40809;Haag am Hausruck;2020;1967;132;67;12;23;2201
AT31;40810;Heiligenberg;2020;685;17;0;0;0;702
AT31;40811;Hofkirchen an der Trattnach;2020;1504;94;50;0;18;1666
AT31;40812;Kallham;2020;2389;71;14;14;9;2497
AT31;40813;Kematen am Innbach;2020;1296;82;16;21;10;1425
AT31;40814;Meggenhofen;2020;1502;38;0;3;24;1567
AT31;40815;Michaelnbach;2020;1230;21;0;0;8;1259
AT31;40816;Natternbach;2020;2228;49;0;0;19;2296
AT31;40817;Neukirchen am Walde;2020;1592;37;3;0;6;1638
AT31;40818;Neumarkt im Hausruckkreis;2020;1252;100;30;88;10;1480
AT31;40820;Pötting;2020;538;3;0;0;0;541
AT31;40821;Pollham;2020;949;14;0;0;10;973
AT31;40822;Pram;2020;1584;83;12;0;7;1686
AT31;40823;Rottenbach;2020;1023;62;15;0;7;1107
AT31;40824;St. Agatha;2020;2100;40;0;0;5;2145
AT31;40825;St. Georgen bei Grieskirchen;2020;1309;23;7;7;6;1352
AT31;40826;St. Thomas;2020;546;19;0;0;0;565
AT31;40827;Schlüßlberg;2020;2795;123;38;58;17;3031
AT31;40828;Steegen;2020;1052;13;8;0;5;1078
AT31;40829;Taufkirchen an der Trattnach;2020;1853;67;8;0;7;1935
AT31;40830;Tollet;2020;906;23;1;0;4;934
AT31;40831;Waizenkirchen;2020;3418;155;86;26;31;3716
AT31;40832;Wallern an der Trattnach;2020;2849;163;32;23;18;3085
AT31;40833;Weibern;2020;1564;84;54;0;13;1715
AT31;40834;Wendling;2020;844;7;0;6;3;860
AT31;40835;Peuerbach;2020;4334;186;48;40;53;4661
AT31;40901;Edlbach;2020;584;31;9;0;11;635
AT31;40902;Grünburg;2020;3466;163;81;117;20;3847
AT31;40903;Hinterstoder;2020;785;93;4;0;20;902
AT31;40904;Inzersdorf im Kremstal;2020;1777;62;12;10;16;1877
AT31;40905;Kirchdorf an der Krems;2020;3794;438;204;81;109;4626
AT31;40906;Klaus an der Pyhrnbahn;2020;955;96;3;0;17;1071
AT31;40907;Kremsmünster;2020;5490;798;254;22;84;6648
AT31;40908;Micheldorf in Oberösterreich;2020;5315;279;172;75;64;5905
AT31;40909;Molln;2020;3273;125;77;118;52;3645
AT31;40910;Nußbach;2020;2204;79;3;0;6;2292
AT31;40911;Oberschlierbach;2020;466;15;1;0;2;484
AT31;40912;Pettenbach;2020;4887;250;52;94;53;5336
AT31;40913;Ried im Traunkreis;2020;2631;164;25;14;15;2849
AT31;40914;Rosenau am Hengstpaß;2020;573;52;25;0;2;652
AT31;40915;Roßleithen;2020;1821;59;21;0;10;1911
AT31;40916;St. Pankraz;2020;322;18;4;0;8;352
AT31;40917;Schlierbach;2020;2653;120;39;8;66;2886
AT31;40918;Spital am Pyhrn;2020;2062;130;26;1;28;2247
AT31;40919;Steinbach am Ziehberg;2020;839;23;1;0;3;866
AT31;40920;Steinbach an der Steyr;2020;1890;64;9;5;13;1981
AT31;40921;Vorderstoder;2020;776;35;0;0;8;819
AT31;40922;Wartberg an der Krems;2020;2707;143;41;27;54;2972
AT31;40923;Windischgarsten;2020;2061;174;82;2;41;2360
AT31;41001;Allhaming;2020;1121;65;2;9;11;1208
AT31;41002;Ansfelden;2020;12983;2137;1071;524;718;17433
AT31;41003;Asten;2020;5703;596;256;133;147;6835
AT31;41004;Eggendorf im Traunkreis;2020;1011;70;5;3;1;1090
AT31;41005;Enns;2020;9164;1497;863;206;170;11900
AT31;41006;Hargelsberg;2020;1360;49;2;1;8;1420
AT31;41007;Hörsching;2020;5418;607;134;66;59;6284
AT31;41008;Hofkirchen im Traunkreis;2020;1797;148;4;1;8;1958
AT31;41009;Kematen an der Krems;2020;2635;186;53;23;78;2975
AT31;41010;Kirchberg-Thening;2020;2378;73;10;6;18;2485
AT31;41011;Kronstorf;2020;3133;276;114;14;15;3552
AT31;41012;Leonding;2020;24514;2312;806;284;1022;28938
AT31;41013;St. Florian;2020;5809;259;35;6;43;6152
AT31;41014;Neuhofen an der Krems;2020;5969;399;169;28;113;6678
AT31;41015;Niederneukirchen;2020;2027;57;13;2;8;2107
AT31;41016;Oftering;2020;2020;75;25;4;10;2134
AT31;41017;Pasching;2020;6484;664;209;151;180;7688
AT31;41018;Piberbach;2020;1783;62;8;13;15;1881
AT31;41019;Pucking;2020;3776;185;69;29;25;4084
AT31;41020;St. Marien;2020;4560;221;44;18;28;4871
AT31;41021;Traun;2020;18375;2998;1969;635;851;24828
AT31;41022;Wilhering;2020;5474;259;56;8;93;5890
AT31;41101;Allerheiligen im Mühlkreis;2020;1239;17;2;0;13;1271
AT31;41102;Arbing;2020;1434;69;9;7;6;1525
AT31;41103;Baumgartenberg;2020;1676;74;6;7;35;1798
AT31;41104;Dimbach;2020;959;4;0;0;2;965
AT31;41105;Grein;2020;2627;182;19;1;76;2905
AT31;41106;Katsdorf;2020;3031;128;0;0;33;3192
AT31;41107;Klam;2020;927;20;2;2;0;951
AT31;41108;Bad Kreuzen;2020;2159;18;2;16;89;2284
AT31;41109;Langenstein;2020;2260;143;16;35;45;2499
AT31;41110;Luftenberg an der Donau;2020;4057;192;48;12;43;4352
AT31;41111;Mauthausen;2020;4123;384;134;216;89;4946
AT31;41112;Mitterkirchen im Machland;2020;1606;70;13;8;21;1718
AT31;41113;Münzbach;2020;1672;122;16;2;21;1833
AT31;41114;Naarn im Machlande;2020;3418;147;48;70;52;3735
AT31;41115;Pabneukirchen;2020;1635;22;11;0;20;1688
AT31;41116;Perg;2020;7424;653;315;278;132;8802
AT31;41117;Rechberg;2020;961;41;1;1;5;1009
AT31;41118;Ried in der Riedmark;2020;4165;109;3;9;25;4311
AT31;41119;St. Georgen am Walde;2020;1946;16;0;0;5;1967
AT31;41120;St. Georgen an der Gusen;2020;3964;190;31;61;138;4384
AT31;41121;St. Nikola an der Donau;2020;637;49;14;5;39;744
AT31;41122;St. Thomas am Blasenstein;2020;899;13;3;0;2;917
AT31;41123;Saxen;2020;1635;78;5;10;21;1749
AT31;41124;Schwertberg;2020;4629;445;71;123;70;5338
AT31;41125;Waldhausen im Strudengau;2020;2731;51;7;4;51;2844
AT31;41126;Windhaag bei Perg;2020;1366;110;28;5;5;1514
AT31;41201;Andrichsfurt;2020;725;55;1;0;2;783
AT31;41202;Antiesenhofen;2020;893;122;29;8;3;1055
AT31;41203;Aurolzmünster;2020;2605;276;105;75;23;3084
AT31;41204;Eberschwang;2020;3190;172;68;3;24;3457
AT31;41205;Eitzing;2020;825;38;4;8;3;878
AT31;41206;Geiersberg;2020;486;10;3;0;0;499
AT31;41207;Geinberg;2020;1229;158;18;7;8;1420
AT31;41208;Gurten;2020;1089;76;16;1;16;1198
AT31;41209;Hohenzell;2020;2154;66;37;4;9;2270
AT31;41210;Kirchdorf am Inn;2020;566;72;1;2;4;645
AT31;41211;Kirchheim im Innkreis;2020;695;22;3;0;4;724
AT31;41212;Lambrechten;2020;1249;67;6;0;6;1328
AT31;41213;Lohnsburg am Kobernaußerwald;2020;2122;83;0;0;6;2211
AT31;41214;Mehrnbach;2020;2152;88;59;9;40;2348
AT31;41215;Mettmach;2020;2290;81;5;1;7;2384
AT31;41216;Mörschwang;2020;315;25;0;0;0;340
AT31;41217;Mühlheim am Inn;2020;598;54;1;0;8;661
AT31;41218;Neuhofen im Innkreis;2020;2296;104;47;15;22;2484
AT31;41219;Obernberg am Inn;2020;1179;419;28;4;13;1643
AT31;41220;Ort im Innkreis;2020;1118;112;18;40;11;1299
AT31;41221;Pattigham;2020;974;33;6;0;8;1021
AT31;41222;Peterskirchen;2020;663;18;0;0;0;681
AT31;41223;Pramet;2020;984;33;4;0;5;1026
AT31;41224;Reichersberg;2020;1359;163;31;6;26;1585
AT31;41225;Ried im Innkreis;2020;9198;1349;558;561;543;12209
AT31;41226;St. Georgen bei Obernberg am Inn;2020;501;43;2;0;7;553
AT31;41227;St. Marienkirchen am Hausruck;2020;872;21;8;2;3;906
AT31;41228;St. Martin im Innkreis;2020;1612;368;86;9;24;2099
AT31;41229;Schildorn;2020;1163;29;0;0;8;1200
AT31;41230;Senftenbach;2020;703;58;7;9;4;781
AT31;41231;Taiskirchen im Innkreis;2020;2308;92;2;2;9;2413
AT31;41232;Tumeltsham;2020;1474;54;38;12;9;1587
AT31;41233;Utzenaich;2020;1495;101;14;4;5;1619
AT31;41234;Waldzell;2020;2172;71;1;5;21;2270
AT31;41235;Weilbach;2020;578;46;0;0;1;625
AT31;41236;Wippenham;2020;543;16;0;1;4;564
AT31;41304;Altenfelden;2020;2185;23;7;11;92;2318
AT31;41305;Arnreit;2020;1122;5;11;0;13;1151
AT31;41306;Atzesberg;2020;434;5;0;0;1;440
AT31;41307;Auberg;2020;561;9;0;0;2;572
AT31;41309;Haslach an der Mühl;2020;2371;84;19;11;63;2548
AT31;41311;Hörbich;2020;397;6;1;0;4;408
AT31;41312;Hofkirchen im Mühlkreis;2020;1455;59;0;1;7;1522
AT31;41313;Julbach;2020;1493;57;0;0;6;1556
AT31;41314;Kirchberg ob der Donau;2020;1037;18;0;0;3;1058
AT31;41315;Klaffer am Hochficht;2020;1222;65;0;3;22;1312
AT31;41316;Kleinzell im Mühlkreis;2020;1645;26;0;10;9;1690
AT31;41317;Kollerschlag;2020;1471;55;0;2;6;1534
AT31;41318;Lembach im Mühlkreis;2020;1423;43;22;2;34;1524
AT31;41319;Lichtenau im Mühlkreis;2020;460;6;0;0;4;470
AT31;41320;Nebelberg;2020;621;28;0;0;2;651
AT31;41321;Neufelden;2020;1043;37;39;0;90;1209
AT31;41322;Niederkappel;2020;960;18;0;0;2;980
AT31;41323;Niederwaldkirchen;2020;1797;31;0;5;8;1841
AT31;41324;Oberkappel;2020;638;59;1;0;15;713
AT31;41325;Oepping;2020;1509;26;4;0;0;1539
AT31;41326;Peilstein im Mühlviertel;2020;1510;26;1;0;5;1542
AT31;41327;Pfarrkirchen im Mühlkreis;2020;1342;61;0;0;14;1417
AT31;41328;Putzleinsdorf;2020;1474;26;16;2;13;1531
AT31;41329;Neustift im Mühlkreis;2020;1360;64;0;0;16;1440
AT31;41331;St. Johann am Wimberg;2020;958;23;1;2;4;988
AT31;41332;St. Martin im Mühlkreis;2020;3585;66;5;35;85;3776
AT31;41333;St. Oswald bei Haslach;2020;492;16;1;0;1;510
AT31;41334;St. Peter am Wimberg;2020;1704;22;0;0;6;1732
AT31;41336;St. Ulrich im Mühlkreis;2020;660;9;0;0;1;670
AT31;41337;St. Veit im Mühlkreis;2020;1233;20;4;0;13;1270
AT31;41338;Sarleinsbach;2020;2201;42;4;1;8;2256
AT31;41341;Schwarzenberg am Böhmerwald;2020;489;78;1;0;3;571
AT31;41342;Ulrichsberg;2020;2677;127;0;0;42;2846
AT31;41343;Aigen-Schlägl;2020;3033;114;31;0;41;3219
AT31;41344;Rohrbach-Berg;2020;4723;179;56;25;199;5182
AT31;41345;Helfenberg;2020;1465;33;4;6;25;1533
AT31;41346;St. Stefan-Afiesl;2020;1071;26;1;0;6;1104
AT31;41401;Altschwendt;2020;675;11;0;2;7;695
AT31;41402;Andorf;2020;4809;174;69;84;67;5203
AT31;41403;Brunnenthal;2020;1855;176;14;6;34;2085
AT31;41404;Diersbach;2020;1472;50;0;1;22;1545
AT31;41405;Dorf an der Pram;2020;1035;27;2;3;5;1072
AT31;41406;Eggerding;2020;1275;54;4;2;4;1339
AT31;41407;Engelhartszell;2020;834;63;3;0;9;909
AT31;41408;Enzenkirchen;2020;1713;70;1;1;9;1794
AT31;41409;Esternberg;2020;2671;173;0;1;5;2850
AT31;41410;Freinberg;2020;1059;374;1;0;6;1440
AT31;41411;Kopfing im Innkreis;2020;1884;69;1;0;16;1970
AT31;41412;Mayrhof;2020;310;7;0;0;1;318
AT31;41413;Münzkirchen;2020;2462;71;4;0;10;2547
AT31;41414;Raab;2020;2118;99;1;19;29;2266
AT31;41415;Rainbach im Innkreis;2020;1465;34;0;11;7;1517
AT31;41416;Riedau;2020;1845;134;19;45;25;2068
AT31;41417;St. Aegidi;2020;1501;32;0;0;8;1541
AT31;41418;St. Florian am Inn;2020;2732;282;13;69;42;3138
AT31;41419;St. Marienkirchen bei Schärding;2020;1773;118;12;29;10;1942
AT31;41420;St. Roman;2020;1698;40;0;0;0;1738
AT31;41421;St. Willibald;2020;1074;46;0;0;2;1122
AT31;41422;Schärding;2020;4004;627;163;181;241;5216
AT31;41423;Schardenberg;2020;2038;382;8;0;26;2454
AT31;41424;Sigharting;2020;792;24;0;3;7;826
AT31;41425;Suben;2020;1215;170;49;39;88;1561
AT31;41426;Taufkirchen an der Pram;2020;2698;124;5;70;43;2940
AT31;41427;Vichtenstein;2020;520;90;2;0;5;617
AT31;41428;Waldkirchen am Wesen;2020;1151;30;0;0;4;1185
AT31;41429;Wernstein am Inn;2020;1367;167;3;1;16;1554
AT31;41430;Zell an der Pram;2020;1846;92;7;29;12;1986
AT31;41501;Adlwang;2020;1844;62;12;5;25;1948
AT31;41502;Aschach an der Steyr;2020;2255;25;12;0;20;2312
AT31;41503;Bad Hall;2020;4821;442;106;92;131;5592
AT31;41504;Dietach;2020;3043;142;77;8;37;3307
AT31;41505;Gaflenz;2020;1849;57;6;0;10;1922
AT31;41506;Garsten;2020;6191;181;61;25;145;6603
AT31;41507;Großraming;2020;2604;50;3;0;14;2671
AT31;41508;Laussa;2020;1213;18;1;0;3;1235
AT31;41509;Losenstein;2020;1503;69;7;0;9;1588
AT31;41510;Maria Neustift;2020;1610;15;0;0;10;1635
AT31;41511;Pfarrkirchen bei Bad Hall;2020;2173;97;14;5;27;2316
AT31;41512;Reichraming;2020;1634;52;4;0;17;1707
AT31;41513;Rohr im Kremstal;2020;1335;62;32;11;5;1445
AT31;41514;St. Ulrich bei Steyr;2020;2964;68;24;1;27;3084
AT31;41515;Schiedlberg;2020;1200;65;10;2;3;1280
AT31;41516;Sierning;2020;8460;493;243;105;112;9413
AT31;41517;Ternberg;2020;3217;101;0;3;49;3370
AT31;41518;Waldneukirchen;2020;2119;55;19;22;23;2238
AT31;41521;Wolfern;2020;3118;62;7;2;13;3202
AT31;41522;Weyer;2020;3790;150;19;7;102;4068
AT31;41601;Alberndorf in der Riedmark;2020;4078;97;9;0;30;4214
AT31;41602;Altenberg bei Linz;2020;4476;113;1;0;43;4633
AT31;41603;Bad Leonfelden;2020;3969;176;26;23;76;4270
AT31;41604;Eidenberg;2020;2015;63;1;0;22;2101
AT31;41605;Engerwitzdorf;2020;8457;251;37;0;114;8859
AT31;41606;Feldkirchen an der Donau;2020;5083;98;70;13;97;5361
AT31;41607;Gallneukirchen;2020;6124;266;73;23;139;6625
AT31;41608;Goldwörth;2020;776;5;2;0;14;797
AT31;41609;Gramastetten;2020;4860;147;8;13;72;5100
AT31;41610;Haibach im Mühlkreis;2020;888;29;0;0;4;921
AT31;41611;Hellmonsödt;2020;2201;90;14;11;33;2349
AT31;41612;Herzogsdorf;2020;2628;39;0;1;7;2675
AT31;41613;Kirchschlag bei Linz;2020;2041;107;8;0;31;2187
AT31;41614;Lichtenberg;2020;2695;69;1;1;21;2787
AT31;41615;Oberneukirchen;2020;3050;68;9;2;39;3168
AT31;41616;Ottenschlag im Mühlkreis;2020;552;9;0;0;3;564
AT31;41617;Ottensheim;2020;4364;200;44;14;142;4764
AT31;41618;Puchenau;2020;4222;214;11;3;81;4531
AT31;41619;Reichenau im Mühlkreis;2020;1253;58;0;0;10;1321
AT31;41620;Reichenthal;2020;1450;29;4;1;5;1489
AT31;41621;St. Gotthard im Mühlkreis;2020;1242;47;0;0;26;1315
AT31;41622;Schenkenfelden;2020;1545;13;3;0;20;1581
AT31;41623;Sonnberg im Mühlkreis;2020;1039;17;0;0;4;1060
AT31;41624;Steyregg;2020;4483;290;71;4;86;4934
AT31;41626;Walding;2020;4006;113;10;10;75;4214
AT31;41627;Zwettl an der Rodl;2020;1651;40;1;9;44;1745
AT31;41628;Vorderweißenbach;2020;2616;40;3;5;6;2670
AT31;41701;Ampflwang im Hausruckwald;2020;2903;378;46;22;39;3388
AT31;41702;Attersee am Attersee;2020;1500;97;2;0;17;1616
AT31;41703;Attnang-Puchheim;2020;6401;1284;744;347;325;9101
AT31;41704;Atzbach;2020;1152;73;0;0;4;1229
AT31;41705;Aurach am Hongar;2020;1711;40;7;3;15;1776
AT31;41706;Berg im Attergau;2020;1028;36;0;0;6;1070
AT31;41707;Desselbrunn;2020;1795;65;16;1;11;1888
AT31;41708;Fornach;2020;934;35;0;0;0;969
AT31;41709;Frankenburg am Hausruck;2020;4574;240;56;6;8;4884
AT31;41710;Frankenmarkt;2020;3131;432;89;44;61;3757
AT31;41711;Gampern;2020;2842;89;18;0;12;2961
AT31;41712;Innerschwand am Mondsee;2020;1128;75;4;1;7;1215
AT31;41713;Lenzing;2020;4522;386;174;23;119;5224
AT31;41714;Manning;2020;773;8;1;0;7;789
AT31;41715;Mondsee;2020;3034;606;167;16;111;3934
AT31;41716;Neukirchen an der Vöckla;2020;2533;84;8;5;10;2640
AT31;41717;Niederthalheim;2020;1016;89;1;13;13;1132
AT31;41718;Nußdorf am Attersee;2020;1009;88;13;1;22;1133
AT31;41719;Oberhofen am Irrsee;2020;1549;117;14;0;16;1696
AT31;41720;Oberndorf bei Schwanenstadt;2020;1235;55;37;2;15;1344
AT31;41721;Oberwang;2020;1682;53;3;0;2;1740
AT31;41722;Ottnang am Hausruck;2020;3562;296;13;4;22;3897
AT31;41723;Pfaffing;2020;1456;41;1;0;17;1515
AT31;41724;Pilsbach;2020;610;17;1;1;2;631
AT31;41725;Pitzenberg;2020;532;9;0;1;4;546
AT31;41726;Pöndorf;2020;2248;136;13;14;7;2418
AT31;41727;Puchkirchen am Trattberg;2020;1030;50;8;0;4;1092
AT31;41728;Pühret;2020;609;8;1;4;0;622
AT31;41729;Redleiten;2020;498;28;0;2;9;537
AT31;41730;Redlham;2020;1526;60;32;2;8;1628
AT31;41731;Regau;2020;6042;435;188;19;90;6774
AT31;41732;Rüstorf;2020;2019;89;66;9;13;2196
AT31;41733;Rutzenham;2020;285;7;4;0;0;296
AT31;41734;St. Georgen im Attergau;2020;3854;349;141;27;121;4492
AT31;41735;St. Lorenz;2020;2296;176;13;10;26;2521
AT31;41736;Schlatt;2020;1274;106;19;10;7;1416
AT31;41737;Schörfling am Attersee;2020;3162;232;41;0;26;3461
AT31;41738;Schwanenstadt;2020;3523;479;288;70;134;4494
AT31;41739;Seewalchen am Attersee;2020;5307;281;45;5;65;5703
AT31;41740;Steinbach am Attersee;2020;802;90;0;0;12;904
AT31;41741;Straß im Attergau;2020;1393;100;17;4;11;1525
AT31;41742;Tiefgraben;2020;3623;312;29;5;45;4014
AT31;41743;Timelkam;2020;5178;366;212;33;127;5916
AT31;41744;Ungenach;2020;1417;52;4;1;13;1487
AT31;41745;Unterach am Attersee;2020;1340;119;34;2;21;1516
AT31;41746;Vöcklabruck;2020;9995;936;603;103;808;12445
AT31;41747;Vöcklamarkt;2020;4428;313;156;51;100;5048
AT31;41748;Weißenkirchen im Attergau;2020;919;36;1;0;0;956
AT31;41749;Weyregg am Attersee;2020;1477;68;4;0;13;1562
AT31;41750;Wolfsegg am Hausruck;2020;1806;192;6;4;26;2034
AT31;41751;Zell am Moos;2020;1488;86;12;8;31;1625
AT31;41752;Zell am Pettenfirst;2020;1171;45;3;1;16;1236
AT31;41801;Aichkirchen;2020;588;17;3;3;2;613
AT31;41802;Bachmanning;2020;630;91;5;11;2;739
AT31;41803;Bad Wimsbach-Neydharting;2020;2415;87;29;26;20;2577
AT31;41804;Buchkirchen;2020;3844;126;25;16;17;4028
AT31;41805;Eberstalzell;2020;2632;94;55;5;34;2820
AT31;41806;Edt bei Lambach;2020;2137;142;41;5;26;2351
AT31;41807;Fischlham;2020;1292;43;4;2;4;1345
AT31;41808;Gunskirchen;2020;5652;530;123;11;27;6343
AT31;41809;Holzhausen;2020;969;46;2;1;4;1022
AT31;41810;Krenglbach;2020;3017;144;22;12;20;3215
AT31;41811;Lambach;2020;2745;445;271;31;91;3583
AT31;41812;Marchtrenk;2020;11889;1509;444;266;226;14334
AT31;41813;Neukirchen bei Lambach;2020;905;42;4;3;10;964
AT31;41814;Offenhausen;2020;1547;132;12;22;6;1719
AT31;41815;Pennewang;2020;896;48;0;0;2;946
AT31;41816;Pichl bei Wels;2020;2651;164;29;50;18;2912
AT31;41817;Sattledt;2020;2326;208;65;69;22;2690
AT31;41818;Schleißheim;2020;1317;81;2;10;12;1422
AT31;41819;Sipbachzell;2020;2018;93;13;12;22;2158
AT31;41820;Stadl-Paura;2020;4085;412;338;68;65;4968
AT31;41821;Steinerkirchen an der Traun;2020;2318;85;14;0;18;2435
AT31;41822;Steinhaus;2020;2231;114;12;0;26;2383
AT31;41823;Thalheim bei Wels;2020;4833;474;135;39;83;5564
AT31;41824;Weißkirchen an der Traun;2020;3164;188;40;23;28;3443
AT31;40101;Linz;2019;155803;20179;12084;3599;14930;206595
AT31;40201;Steyr;2019;30515;2814;2383;924;1420;38056
AT31;40301;Wels;2019;44965;7326;5689;1681;2809;62470
AT31;40401;Altheim;2019;4307;471;155;16;40;4989
AT31;40402;Aspach;2019;2367;217;15;1;13;2613
AT31;40403;Auerbach;2019;579;48;29;0;5;661
AT31;40404;Braunau am Inn;2019;12948;2246;1205;151;968;17518
AT31;40405;Burgkirchen;2019;2430;191;66;1;21;2709
AT31;40406;Eggelsberg;2019;2204;194;25;5;21;2449
AT31;40407;Feldkirchen bei Mattighofen;2019;1906;84;8;2;12;2012
AT31;40408;Franking;2019;890;113;7;0;2;1012
AT31;40409;Geretsberg;2019;1064;95;2;0;18;1179
AT31;40410;Gilgenberg am Weilhart;2019;1221;110;6;0;16;1353
AT31;40411;Haigermoos;2019;586;36;1;0;3;626
AT31;40412;Handenberg;2019;1216;77;12;0;3;1308
AT31;40413;Helpfau-Uttendorf;2019;2798;602;245;18;44;3707
AT31;40414;Hochburg-Ach;2019;2491;718;15;1;39;3264
AT31;40415;Höhnhart;2019;1341;84;0;0;14;1439
AT31;40416;Jeging;2019;608;62;8;24;3;705
AT31;40417;Kirchberg bei Mattighofen;2019;1122;52;1;11;5;1191
AT31;40418;Lengau;2019;4275;334;136;45;29;4819
AT31;40419;Lochen am See;2019;2693;108;7;10;5;2823
AT31;40420;Maria Schmolln;2019;1350;50;0;1;18;1419
AT31;40421;Mattighofen;2019;4410;1161;1054;130;172;6927
AT31;40422;Mauerkirchen;2019;1897;356;219;0;38;2510
AT31;40423;Mining;2019;1164;73;3;2;12;1254
AT31;40424;Moosbach;2019;927;128;15;0;12;1082
AT31;40425;Moosdorf;2019;1521;149;9;0;13;1692
AT31;40426;Munderfing;2019;2692;225;99;27;56;3099
AT31;40427;Neukirchen an der Enknach;2019;2079;145;27;4;41;2296
AT31;40428;Ostermiething;2019;2828;340;75;9;24;3276
AT31;40429;Palting;2019;935;30;7;0;8;980
AT31;40430;Perwang am Grabensee;2019;960;69;3;0;3;1035
AT31;40431;Pfaffstätt;2019;927;187;34;0;4;1152
AT31;40432;Pischelsdorf am Engelbach;2019;1512;159;10;2;19;1702
AT31;40433;Polling im Innkreis;2019;930;59;7;0;8;1004
AT31;40434;Roßbach;2019;857;39;0;0;4;900
AT31;40435;St. Georgen am Fillmannsbach;2019;405;16;0;0;0;421
AT31;40436;St. Johann am Walde;2019;1928;102;3;1;8;2042
AT31;40437;St. Pantaleon;2019;2705;273;122;8;54;3162
AT31;40438;St. Peter am Hart;2019;2082;241;9;16;65;2413
AT31;40439;St. Radegund;2019;529;51;3;0;0;583
AT31;40440;St. Veit im Innkreis;2019;374;27;0;0;1;402
AT31;40441;Schalchen;2019;3353;328;255;16;37;3989
AT31;40442;Schwand im Innkreis;2019;935;51;0;0;9;995
AT31;40443;Tarsdorf;2019;1877;162;14;1;6;2060
AT31;40444;Treubach;2019;661;50;4;0;6;721
AT31;40445;Überackern;2019;483;195;0;0;5;683
AT31;40446;Weng im Innkreis;2019;1293;56;5;0;23;1377
AT31;40501;Alkoven;2019;5502;261;103;26;112;6004
AT31;40502;Aschach an der Donau;2019;1841;121;167;6;32;2167
AT31;40503;Eferding;2019;3422;236;436;26;139;4259
AT31;40504;Fraham;2019;2215;87;75;0;14;2391
AT31;40505;Haibach ob der Donau;2019;1259;23;1;0;6;1289
AT31;40506;Hartkirchen;2019;3925;41;59;4;44;4073
AT31;40507;Hinzenbach;2019;1932;59;67;3;13;2074
AT31;40508;Prambachkirchen;2019;2751;109;43;5;25;2933
AT31;40509;Pupping;2019;1688;40;38;2;15;1783
AT31;40510;St. Marienkirchen an der Polsenz;2019;2219;68;11;10;6;2314
AT31;40511;Scharten;2019;2174;50;35;0;18;2277
AT31;40512;Stroheim;2019;1590;20;0;1;3;1614
AT31;40601;Freistadt;2019;7180;240;51;256;254;7981
AT31;40602;Grünbach;2019;1893;26;0;3;15;1937
AT31;40603;Gutau;2019;2658;56;2;0;19;2735
AT31;40604;Hagenberg im Mühlkreis;2019;2657;69;3;1;34;2764
AT31;40605;Hirschbach im Mühlkreis;2019;1156;19;0;0;5;1180
AT31;40606;Kaltenberg;2019;612;8;0;0;0;620
AT31;40607;Kefermarkt;2019;2070;52;3;0;11;2136
AT31;40608;Königswiesen;2019;3051;26;1;0;5;3083
AT31;40609;Lasberg;2019;2755;40;2;12;27;2836
AT31;40610;Leopoldschlag;2019;970;19;0;9;3;1001
AT31;40611;Liebenau;2019;1552;6;1;0;2;1561
AT31;40612;Neumarkt im Mühlkreis;2019;3090;55;1;3;24;3173
AT31;40613;Pierbach;2019;1006;12;0;0;7;1025
AT31;40614;Pregarten;2019;5259;172;35;11;67;5544
AT31;40615;Rainbach im Mühlkreis;2019;2876;66;1;22;22;2987
AT31;40616;Sandl;2019;1345;37;0;3;7;1392
AT31;40617;St. Leonhard bei Freistadt;2019;1341;24;0;0;5;1370
AT31;40618;St. Oswald bei Freistadt;2019;2789;61;7;4;15;2876
AT31;40619;Schönau im Mühlkreis;2019;1933;22;0;0;3;1958
AT31;40620;Tragwein;2019;3021;50;8;0;43;3122
AT31;40621;Unterweißenbach;2019;2139;18;1;5;8;2171
AT31;40622;Unterweitersdorf;2019;2129;31;4;2;15;2181
AT31;40623;Waldburg;2019;1389;14;0;0;1;1404
AT31;40624;Wartberg ob der Aist;2019;4194;80;5;2;27;4308
AT31;40625;Weitersfelden;2019;1021;39;0;0;3;1063
AT31;40626;Windhaag bei Freistadt;2019;1516;23;1;29;1;1570
AT31;40627;Bad Zell;2019;2821;25;17;5;15;2883
AT31;40701;Altmünster;2019;9070;579;92;14;101;9856
AT31;40702;Bad Goisern am Hallstättersee;2019;7072;397;18;6;67;7560
AT31;40703;Bad Ischl;2019;12213;1148;178;185;346;14070
AT31;40704;Ebensee am Traunsee;2019;7084;408;100;5;80;7677
AT31;40705;Gmunden;2019;10899;1314;605;84;373;13275
AT31;40706;Gosau;2019;1636;132;6;0;20;1794
AT31;40707;Grünau im Almtal;2019;1904;102;14;14;26;2060
AT31;40708;Gschwandt;2019;2697;77;29;8;17;2828
AT31;40709;Hallstatt;2019;622;104;14;0;14;754
AT31;40710;Kirchham;2019;2093;65;7;12;11;2188
AT31;40711;Laakirchen;2019;8342;549;766;58;128;9843
AT31;40712;Obertraun;2019;615;98;0;0;36;749
AT31;40713;Ohlsdorf;2019;4874;204;104;16;13;5211
AT31;40714;Pinsdorf;2019;3533;292;156;9;39;4029
AT31;40715;Roitham am Traunfall;2019;1885;84;5;4;14;1992
AT31;40716;St. Konrad;2019;1091;49;1;0;3;1144
AT31;40717;St. Wolfgang im Salzkammergut;2019;2536;181;50;2;33;2802
AT31;40718;Traunkirchen;2019;1533;70;9;4;16;1632
AT31;40719;Scharnstein;2019;4489;253;68;26;35;4871
AT31;40720;Vorchdorf;2019;6835;317;179;133;60;7524
AT31;40801;Aistersheim;2019;863;43;10;0;5;921
AT31;40802;Bad Schallerbach;2019;3512;450;188;18;42;4210
AT31;40804;Eschenau im Hausruckkreis;2019;1047;11;0;0;3;1061
AT31;40805;Gallspach;2019;2128;354;199;64;36;2781
AT31;40806;Gaspoltshofen;2019;3304;200;38;19;34;3595
AT31;40807;Geboltskirchen;2019;1373;44;2;0;26;1445
AT31;40808;Grieskirchen;2019;4057;318;188;265;159;4987
AT31;40809;Haag am Hausruck;2019;1978;124;67;9;23;2201
AT31;40810;Heiligenberg;2019;679;22;0;0;1;702
AT31;40811;Hofkirchen an der Trattnach;2019;1500;82;40;0;17;1639
AT31;40812;Kallham;2019;2398;73;14;15;9;2509
AT31;40813;Kematen am Innbach;2019;1322;69;14;20;6;1431
AT31;40814;Meggenhofen;2019;1471;36;0;3;20;1530
AT31;40815;Michaelnbach;2019;1235;22;0;1;10;1268
AT31;40816;Natternbach;2019;2214;49;0;0;24;2287
AT31;40817;Neukirchen am Walde;2019;1590;36;6;0;6;1638
AT31;40818;Neumarkt im Hausruckkreis;2019;1239;82;28;84;9;1442
AT31;40820;Pötting;2019;527;4;0;0;0;531
AT31;40821;Pollham;2019;942;15;0;0;13;970
AT31;40822;Pram;2019;1549;71;8;1;9;1638
AT31;40823;Rottenbach;2019;1018;56;14;0;5;1093
AT31;40824;St. Agatha;2019;2097;26;0;0;8;2131
AT31;40825;St. Georgen bei Grieskirchen;2019;1302;23;3;6;6;1340
AT31;40826;St. Thomas;2019;535;14;0;0;0;549
AT31;40827;Schlüßlberg;2019;2817;111;45;58;19;3050
AT31;40828;Steegen;2019;1038;13;8;0;5;1064
AT31;40829;Taufkirchen an der Trattnach;2019;1886;69;7;0;5;1967
AT31;40830;Tollet;2019;894;23;0;0;4;921
AT31;40831;Waizenkirchen;2019;3434;138;93;26;24;3715
AT31;40832;Wallern an der Trattnach;2019;2834;157;32;23;21;3067
AT31;40833;Weibern;2019;1543;74;60;0;11;1688
AT31;40834;Wendling;2019;841;6;0;5;2;854
AT31;40835;Peuerbach;2019;4334;172;44;42;58;4650
AT31;40901;Edlbach;2019;591;32;9;0;15;647
AT31;40902;Grünburg;2019;3493;139;69;122;34;3857
AT31;40903;Hinterstoder;2019;788;95;5;0;19;907
AT31;40904;Inzersdorf im Kremstal;2019;1789;63;16;9;18;1895
AT31;40905;Kirchdorf an der Krems;2019;3813;383;181;71;111;4559
AT31;40906;Klaus an der Pyhrnbahn;2019;941;99;3;0;18;1061
AT31;40907;Kremsmünster;2019;5589;736;255;23;94;6697
AT31;40908;Micheldorf in Oberösterreich;2019;5303;273;165;77;60;5878
AT31;40909;Molln;2019;3253;121;81;120;46;3621
AT31;40910;Nußbach;2019;2215;74;7;0;9;2305
AT31;40911;Oberschlierbach;2019;476;13;1;0;2;492
AT31;40912;Pettenbach;2019;4885;244;58;89;45;5321
AT31;40913;Ried im Traunkreis;2019;2602;135;17;15;16;2785
AT31;40914;Rosenau am Hengstpaß;2019;568;50;29;0;3;650
AT31;40915;Roßleithen;2019;1813;62;28;0;9;1912
AT31;40916;St. Pankraz;2019;324;23;4;0;8;359
AT31;40917;Schlierbach;2019;2617;118;40;6;69;2850
AT31;40918;Spital am Pyhrn;2019;2074;130;25;1;21;2251
AT31;40919;Steinbach am Ziehberg;2019;830;17;1;0;2;850
AT31;40920;Steinbach an der Steyr;2019;1890;52;10;10;16;1978
AT31;40921;Vorderstoder;2019;780;35;0;0;11;826
AT31;40922;Wartberg an der Krems;2019;2732;133;37;32;44;2978
AT31;40923;Windischgarsten;2019;2080;168;96;2;46;2392
AT31;41001;Allhaming;2019;1105;49;1;9;11;1175
AT31;41002;Ansfelden;2019;12942;1877;1029;515;729;17092
AT31;41003;Asten;2019;5644;560;239;135;140;6718
AT31;41004;Eggendorf im Traunkreis;2019;977;57;3;3;1;1041
AT31;41005;Enns;2019;9265;1391;892;199;193;11940
AT31;41006;Hargelsberg;2019;1342;45;2;0;12;1401
AT31;41007;Hörsching;2019;5392;564;129;71;53;6209
AT31;41008;Hofkirchen im Traunkreis;2019;1784;141;4;1;18;1948
AT31;41009;Kematen an der Krems;2019;2606;168;49;24;62;2909
AT31;41010;Kirchberg-Thening;2019;2317;76;18;5;19;2435
AT31;41011;Kronstorf;2019;3137;286;100;15;14;3552
AT31;41012;Leonding;2019;24621;2283;778;279;968;28929
AT31;41013;St. Florian;2019;5855;253;28;5;40;6181
AT31;41014;Neuhofen an der Krems;2019;5944;365;169;26;133;6637
AT31;41015;Niederneukirchen;2019;2017;63;13;2;13;2108
AT31;41016;Oftering;2019;2015;55;26;5;9;2110
AT31;41017;Pasching;2019;6417;677;209;153;173;7629
AT31;41018;Piberbach;2019;1790;61;8;2;14;1875
AT31;41019;Pucking;2019;3719;166;52;23;19;3979
AT31;41020;St. Marien;2019;4561;186;35;24;22;4828
AT31;41021;Traun;2019;18498;2834;1910;631;883;24756
AT31;41022;Wilhering;2019;5509;241;62;13;94;5919
AT31;41101;Allerheiligen im Mühlkreis;2019;1234;16;2;0;15;1267
AT31;41102;Arbing;2019;1412;70;9;8;8;1507
AT31;41103;Baumgartenberg;2019;1666;67;6;7;43;1789
AT31;41104;Dimbach;2019;959;4;0;0;2;965
AT31;41105;Grein;2019;2641;178;18;1;72;2910
AT31;41106;Katsdorf;2019;3022;127;0;0;33;3182
AT31;41107;Klam;2019;913;23;2;2;0;940
AT31;41108;Bad Kreuzen;2019;2146;19;9;6;111;2291
AT31;41109;Langenstein;2019;2262;140;16;32;52;2502
AT31;41110;Luftenberg an der Donau;2019;3997;181;46;17;38;4279
AT31;41111;Mauthausen;2019;4161;347;121;208;87;4924
AT31;41112;Mitterkirchen im Machland;2019;1621;65;12;8;10;1716
AT31;41113;Münzbach;2019;1640;128;17;2;21;1808
AT31;41114;Naarn im Machlande;2019;3396;149;48;70;45;3708
AT31;41115;Pabneukirchen;2019;1647;21;10;0;16;1694
AT31;41116;Perg;2019;7454;647;321;272;143;8837
AT31;41117;Rechberg;2019;972;31;1;1;1;1006
AT31;41118;Ried in der Riedmark;2019;4157;87;3;7;53;4307
AT31;41119;St. Georgen am Walde;2019;1942;18;0;0;5;1965
AT31;41120;St. Georgen an der Gusen;2019;3901;160;21;63;117;4262
AT31;41121;St. Nikola an der Donau;2019;641;44;11;9;57;762
AT31;41122;St. Thomas am Blasenstein;2019;894;12;2;0;3;911
AT31;41123;Saxen;2019;1637;78;5;17;19;1756
AT31;41124;Schwertberg;2019;4638;399;72;135;77;5321
AT31;41125;Waldhausen im Strudengau;2019;2736;51;11;0;55;2853
AT31;41126;Windhaag bei Perg;2019;1360;103;32;6;5;1506
AT31;41201;Andrichsfurt;2019;736;41;1;1;2;781
AT31;41202;Antiesenhofen;2019;915;120;28;6;14;1083
AT31;41203;Aurolzmünster;2019;2644;260;92;70;31;3097
AT31;41204;Eberschwang;2019;3190;161;72;1;46;3470
AT31;41205;Eitzing;2019;811;32;4;5;3;855
AT31;41206;Geiersberg;2019;497;9;3;0;0;509
AT31;41207;Geinberg;2019;1229;142;19;7;11;1408
AT31;41208;Gurten;2019;1090;72;16;1;17;1196
AT31;41209;Hohenzell;2019;2149;67;37;4;10;2267
AT31;41210;Kirchdorf am Inn;2019;563;62;7;3;4;639
AT31;41211;Kirchheim im Innkreis;2019;699;20;1;0;4;724
AT31;41212;Lambrechten;2019;1265;57;4;0;6;1332
AT31;41213;Lohnsburg am Kobernaußerwald;2019;2149;81;0;0;6;2236
AT31;41214;Mehrnbach;2019;2166;93;58;9;35;2361
AT31;41215;Mettmach;2019;2278;66;6;1;3;2354
AT31;41216;Mörschwang;2019;315;27;0;0;1;343
AT31;41217;Mühlheim am Inn;2019;595;54;2;0;9;660
AT31;41218;Neuhofen im Innkreis;2019;2282;103;48;14;20;2467
AT31;41219;Obernberg am Inn;2019;1213;361;27;6;10;1617
AT31;41220;Ort im Innkreis;2019;1111;114;19;27;15;1286
AT31;41221;Pattigham;2019;949;33;5;1;8;996
AT31;41222;Peterskirchen;2019;673;17;0;0;0;690
AT31;41223;Pramet;2019;981;32;4;1;5;1023
AT31;41224;Reichersberg;2019;1351;157;30;10;15;1563
AT31;41225;Ried im Innkreis;2019;9317;1245;544;584;530;12220
AT31;41226;St. Georgen bei Obernberg am Inn;2019;507;47;2;0;12;568
AT31;41227;St. Marienkirchen am Hausruck;2019;848;18;6;2;3;877
AT31;41228;St. Martin im Innkreis;2019;1605;359;86;9;21;2080
AT31;41229;Schildorn;2019;1157;38;0;0;14;1209
AT31;41230;Senftenbach;2019;708;47;7;9;2;773
AT31;41231;Taiskirchen im Innkreis;2019;2318;85;3;2;8;2416
AT31;41232;Tumeltsham;2019;1475;57;42;12;13;1599
AT31;41233;Utzenaich;2019;1455;105;18;5;4;1587
AT31;41234;Waldzell;2019;2127;70;1;4;15;2217
AT31;41235;Weilbach;2019;578;43;0;0;1;622
AT31;41236;Wippenham;2019;539;17;0;1;8;565
AT31;41304;Altenfelden;2019;2146;19;4;11;70;2250
AT31;41305;Arnreit;2019;1115;4;11;0;6;1136
AT31;41306;Atzesberg;2019;431;5;0;0;1;437
AT31;41307;Auberg;2019;541;13;0;0;2;556
AT31;41309;Haslach an der Mühl;2019;2403;75;16;12;58;2564
AT31;41311;Hörbich;2019;390;5;1;0;2;398
AT31;41312;Hofkirchen im Mühlkreis;2019;1443;44;0;2;18;1507
AT31;41313;Julbach;2019;1488;48;0;0;4;1540
AT31;41314;Kirchberg ob der Donau;2019;1021;15;0;0;9;1045
AT31;41315;Klaffer am Hochficht;2019;1222;55;0;0;21;1298
AT31;41316;Kleinzell im Mühlkreis;2019;1615;21;0;6;8;1650
AT31;41317;Kollerschlag;2019;1456;52;0;2;6;1516
AT31;41318;Lembach im Mühlkreis;2019;1427;41;22;2;31;1523
AT31;41319;Lichtenau im Mühlkreis;2019;466;13;0;0;5;484
AT31;41320;Nebelberg;2019;616;21;0;0;1;638
AT31;41321;Neufelden;2019;1083;45;44;0;77;1249
AT31;41322;Niederkappel;2019;963;19;0;0;1;983
AT31;41323;Niederwaldkirchen;2019;1783;34;0;6;12;1835
AT31;41324;Oberkappel;2019;645;57;0;0;20;722
AT31;41325;Oepping;2019;1496;21;4;0;0;1521
AT31;41326;Peilstein im Mühlviertel;2019;1507;25;0;0;9;1541
AT31;41327;Pfarrkirchen im Mühlkreis;2019;1373;57;0;0;19;1449
AT31;41328;Putzleinsdorf;2019;1484;33;11;0;13;1541
AT31;41329;Neustift im Mühlkreis;2019;1371;65;0;0;24;1460
AT31;41331;St. Johann am Wimberg;2019;968;22;1;2;5;998
AT31;41332;St. Martin im Mühlkreis;2019;3610;62;6;34;62;3774
AT31;41333;St. Oswald bei Haslach;2019;477;15;0;0;0;492
AT31;41334;St. Peter am Wimberg;2019;1714;24;0;1;7;1746
AT31;41336;St. Ulrich im Mühlkreis;2019;636;7;0;0;1;644
AT31;41337;St. Veit im Mühlkreis;2019;1218;19;4;0;6;1247
AT31;41338;Sarleinsbach;2019;2218;38;4;1;11;2272
AT31;41341;Schwarzenberg am Böhmerwald;2019;497;69;1;0;3;570
AT31;41342;Ulrichsberg;2019;2682;122;1;0;45;2850
AT31;41343;Aigen-Schlägl;2019;3050;108;31;0;52;3241
AT31;41344;Rohrbach-Berg;2019;4778;181;62;22;176;5219
AT31;41345;Helfenberg;2019;1484;28;4;5;20;1541
AT31;41346;St. Stefan-Afiesl;2019;1075;22;1;0;10;1108
AT31;41401;Altschwendt;2019;672;15;0;2;13;702
AT31;41402;Andorf;2019;4824;170;66;81;70;5211
AT31;41403;Brunnenthal;2019;1876;173;13;9;27;2098
AT31;41404;Diersbach;2019;1495;48;0;0;20;1563
AT31;41405;Dorf an der Pram;2019;1013;27;1;3;3;1047
AT31;41406;Eggerding;2019;1278;52;1;2;4;1337
AT31;41407;Engelhartszell;2019;833;73;3;1;12;922
AT31;41408;Enzenkirchen;2019;1703;64;2;0;9;1778
AT31;41409;Esternberg;2019;2685;170;0;1;10;2866
AT31;41410;Freinberg;2019;1072;355;1;0;5;1433
AT31;41411;Kopfing im Innkreis;2019;1900;60;1;0;24;1985
AT31;41412;Mayrhof;2019;313;10;0;0;1;324
AT31;41413;Münzkirchen;2019;2441;72;3;0;16;2532
AT31;41414;Raab;2019;2106;101;1;23;37;2268
AT31;41415;Rainbach im Innkreis;2019;1446;28;0;9;7;1490
AT31;41416;Riedau;2019;1848;128;25;46;25;2072
AT31;41417;St. Aegidi;2019;1514;29;0;0;8;1551
AT31;41418;St. Florian am Inn;2019;2748;246;13;69;62;3138
AT31;41419;St. Marienkirchen bei Schärding;2019;1743;107;12;27;8;1897
AT31;41420;St. Roman;2019;1687;41;0;0;0;1728
AT31;41421;St. Willibald;2019;1066;35;0;0;2;1103
AT31;41422;Schärding;2019;4064;581;158;181;285;5269
AT31;41423;Schardenberg;2019;2050;362;8;0;20;2440
AT31;41424;Sigharting;2019;794;24;0;3;3;824
AT31;41425;Suben;2019;1204;162;46;40;100;1552
AT31;41426;Taufkirchen an der Pram;2019;2696;112;5;67;35;2915
AT31;41427;Vichtenstein;2019;515;82;0;0;12;609
AT31;41428;Waldkirchen am Wesen;2019;1153;27;0;0;5;1185
AT31;41429;Wernstein am Inn;2019;1369;148;3;0;20;1540
AT31;41430;Zell an der Pram;2019;1881;84;5;28;14;2012
AT31;41501;Adlwang;2019;1789;58;10;4;13;1874
AT31;41502;Aschach an der Steyr;2019;2266;19;13;0;14;2312
AT31;41503;Bad Hall;2019;4733;423;111;80;147;5494
AT31;41504;Dietach;2019;2991;144;83;7;45;3270
AT31;41505;Gaflenz;2019;1857;52;7;0;15;1931
AT31;41506;Garsten;2019;6240;175;50;20;155;6640
AT31;41507;Großraming;2019;2613;45;4;0;15;2677
AT31;41508;Laussa;2019;1214;16;0;0;2;1232
AT31;41509;Losenstein;2019;1531;79;7;0;10;1627
AT31;41510;Maria Neustift;2019;1587;18;0;0;9;1614
AT31;41511;Pfarrkirchen bei Bad Hall;2019;2164;94;12;5;34;2309
AT31;41512;Reichraming;2019;1640;47;5;0;16;1708
AT31;41513;Rohr im Kremstal;2019;1311;63;26;7;15;1422
AT31;41514;St. Ulrich bei Steyr;2019;2948;55;21;1;18;3043
AT31;41515;Schiedlberg;2019;1174;55;10;1;9;1249
AT31;41516;Sierning;2019;8473;447;232;107;116;9375
AT31;41517;Ternberg;2019;3246;87;3;2;51;3389
AT31;41518;Waldneukirchen;2019;2104;65;21;18;22;2230
AT31;41521;Wolfern;2019;3104;58;7;1;8;3178
AT31;41522;Weyer;2019;3877;146;18;7;95;4143
AT31;41601;Alberndorf in der Riedmark;2019;4057;91;6;0;26;4180
AT31;41602;Altenberg bei Linz;2019;4520;106;1;0;45;4672
AT31;41603;Bad Leonfelden;2019;3946;162;25;22;105;4260
AT31;41604;Eidenberg;2019;2050;55;1;0;22;2128
AT31;41605;Engerwitzdorf;2019;8459;221;34;1;125;8840
AT31;41606;Feldkirchen an der Donau;2019;5097;107;103;12;76;5395
AT31;41607;Gallneukirchen;2019;6085;249;70;22;141;6567
AT31;41608;Goldwörth;2019;792;6;2;0;13;813
AT31;41609;Gramastetten;2019;4901;140;8;7;58;5114
AT31;41610;Haibach im Mühlkreis;2019;887;29;0;0;5;921
AT31;41611;Hellmonsödt;2019;2181;90;7;11;36;2325
AT31;41612;Herzogsdorf;2019;2606;38;2;1;8;2655
AT31;41613;Kirchschlag bei Linz;2019;2048;110;7;0;36;2201
AT31;41614;Lichtenberg;2019;2639;68;0;1;20;2728
AT31;41615;Oberneukirchen;2019;3084;62;9;2;39;3196
AT31;41616;Ottenschlag im Mühlkreis;2019;549;8;0;0;4;561
AT31;41617;Ottensheim;2019;4364;201;41;11;121;4738
AT31;41618;Puchenau;2019;4198;184;9;3;83;4477
AT31;41619;Reichenau im Mühlkreis;2019;1247;57;0;0;19;1323
AT31;41620;Reichenthal;2019;1450;28;4;1;8;1491
AT31;41621;St. Gotthard im Mühlkreis;2019;1242;36;0;0;26;1304
AT31;41622;Schenkenfelden;2019;1544;13;4;0;18;1579
AT31;41623;Sonnberg im Mühlkreis;2019;1000;15;0;0;4;1019
AT31;41624;Steyregg;2019;4511;267;70;2;82;4932
AT31;41626;Walding;2019;3950;116;15;10;67;4158
AT31;41627;Zwettl an der Rodl;2019;1657;36;1;9;51;1754
AT31;41628;Vorderweißenbach;2019;2623;37;3;5;6;2674
AT31;41701;Ampflwang im Hausruckwald;2019;2922;342;54;22;42;3382
AT31;41702;Attersee am Attersee;2019;1474;111;2;0;17;1604
AT31;41703;Attnang-Puchheim;2019;6457;1206;762;344;331;9100
AT31;41704;Atzbach;2019;1145;69;0;0;3;1217
AT31;41705;Aurach am Hongar;2019;1658;39;7;3;13;1720
AT31;41706;Berg im Attergau;2019;1034;32;0;0;6;1072
AT31;41707;Desselbrunn;2019;1778;57;12;0;10;1857
AT31;41708;Fornach;2019;938;35;0;0;0;973
AT31;41709;Frankenburg am Hausruck;2019;4618;214;52;7;9;4900
AT31;41710;Frankenmarkt;2019;3120;392;83;44;51;3690
AT31;41711;Gampern;2019;2855;89;22;0;10;2976
AT31;41712;Innerschwand am Mondsee;2019;1097;62;5;1;8;1173
AT31;41713;Lenzing;2019;4513;382;170;25;129;5219
AT31;41714;Manning;2019;773;11;1;0;2;787
AT31;41715;Mondsee;2019;2962;574;170;12;114;3832
AT31;41716;Neukirchen an der Vöckla;2019;2517;87;10;0;8;2622
AT31;41717;Niederthalheim;2019;1012;54;1;13;18;1098
AT31;41718;Nußdorf am Attersee;2019;1023;95;13;1;19;1151
AT31;41719;Oberhofen am Irrsee;2019;1548;118;12;0;14;1692
AT31;41720;Oberndorf bei Schwanenstadt;2019;1262;52;37;2;23;1376
AT31;41721;Oberwang;2019;1669;60;6;0;2;1737
AT31;41722;Ottnang am Hausruck;2019;3587;275;11;4;34;3911
AT31;41723;Pfaffing;2019;1427;45;1;0;10;1483
AT31;41724;Pilsbach;2019;604;13;1;1;3;622
AT31;41725;Pitzenberg;2019;530;11;0;1;4;546
AT31;41726;Pöndorf;2019;2258;132;14;15;11;2430
AT31;41727;Puchkirchen am Trattberg;2019;1019;35;5;0;4;1063
AT31;41728;Pühret;2019;615;9;1;0;0;625
AT31;41729;Redleiten;2019;488;39;0;2;14;543
AT31;41730;Redlham;2019;1534;66;28;2;7;1637
AT31;41731;Regau;2019;6036;390;169;16;80;6691
AT31;41732;Rüstorf;2019;2012;86;63;7;14;2182
AT31;41733;Rutzenham;2019;287;8;4;0;0;299
AT31;41734;St. Georgen im Attergau;2019;3812;323;140;28;152;4455
AT31;41735;St. Lorenz;2019;2305;163;15;12;24;2519
AT31;41736;Schlatt;2019;1277;97;15;11;3;1403
AT31;41737;Schörfling am Attersee;2019;3196;221;35;0;28;3480
AT31;41738;Schwanenstadt;2019;3467;444;293;68;135;4407
AT31;41739;Seewalchen am Attersee;2019;5264;299;48;3;55;5669
AT31;41740;Steinbach am Attersee;2019;792;86;0;0;9;887
AT31;41741;Straß im Attergau;2019;1377;88;15;3;10;1493
AT31;41742;Tiefgraben;2019;3608;306;32;4;44;3994
AT31;41743;Timelkam;2019;5167;326;190;33;138;5854
AT31;41744;Ungenach;2019;1420;69;0;1;12;1502
AT31;41745;Unterach am Attersee;2019;1326;128;37;1;21;1513
AT31;41746;Vöcklabruck;2019;10026;884;604;96;768;12378
AT31;41747;Vöcklamarkt;2019;4478;317;168;53;92;5108
AT31;41748;Weißenkirchen im Attergau;2019;940;33;1;0;0;974
AT31;41749;Weyregg am Attersee;2019;1470;73;4;0;15;1562
AT31;41750;Wolfsegg am Hausruck;2019;1787;188;2;6;24;2007
AT31;41751;Zell am Moos;2019;1479;87;12;8;38;1624
AT31;41752;Zell am Pettenfirst;2019;1195;45;3;1;14;1258
AT31;41801;Aichkirchen;2019;576;16;3;3;2;600
AT31;41802;Bachmanning;2019;633;83;10;11;2;739
AT31;41803;Bad Wimsbach-Neydharting;2019;2426;89;35;26;19;2595
AT31;41804;Buchkirchen;2019;3858;132;24;17;14;4045
AT31;41805;Eberstalzell;2019;2533;87;54;4;28;2706
AT31;41806;Edt bei Lambach;2019;2072;132;44;8;13;2269
AT31;41807;Fischlham;2019;1309;37;7;2;3;1358
AT31;41808;Gunskirchen;2019;5640;476;117;12;35;6280
AT31;41809;Holzhausen;2019;970;44;7;1;4;1026
AT31;41810;Krenglbach;2019;2999;132;22;11;20;3184
AT31;41811;Lambach;2019;2778;434;258;29;106;3605
AT31;41812;Marchtrenk;2019;11729;1403;426;264;248;14070
AT31;41813;Neukirchen bei Lambach;2019;889;33;4;2;7;935
AT31;41814;Offenhausen;2019;1544;129;12;21;5;1711
AT31;41815;Pennewang;2019;892;30;0;0;1;923
AT31;41816;Pichl bei Wels;2019;2659;154;26;52;20;2911
AT31;41817;Sattledt;2019;2350;188;70;74;24;2706
AT31;41818;Schleißheim;2019;1328;77;4;8;12;1429
AT31;41819;Sipbachzell;2019;1974;84;12;9;21;2100
AT31;41820;Stadl-Paura;2019;4089;405;347;62;84;4987
AT31;41821;Steinerkirchen an der Traun;2019;2275;81;14;0;16;2386
AT31;41822;Steinhaus;2019;2138;97;11;1;21;2268
AT31;41823;Thalheim bei Wels;2019;4853;432;140;26;79;5530
AT31;41824;Weißkirchen an der Traun;2019;3160;173;28;25;28;3414
AT31;40101;Linz;2018;156886;19274;11811;3554;14201;205726
AT31;40201;Steyr;2018;30902;2610;2378;917;1386;38193
AT31;40301;Wels;2018;45382;6639;5501;1644;2561;61727
AT31;40401;Altheim;2018;4282;449;155;11;36;4933
AT31;40402;Aspach;2018;2383;192;17;1;12;2605
AT31;40403;Auerbach;2018;548;41;12;0;5;606
AT31;40404;Braunau am Inn;2018;12968;2002;1181;147;930;17228
AT31;40405;Burgkirchen;2018;2431;194;70;1;21;2717
AT31;40406;Eggelsberg;2018;2184;190;29;5;21;2429
AT31;40407;Feldkirchen bei Mattighofen;2018;1880;88;10;0;12;1990
AT31;40408;Franking;2018;891;104;5;0;2;1002
AT31;40409;Geretsberg;2018;1063;86;2;0;23;1174
AT31;40410;Gilgenberg am Weilhart;2018;1206;107;8;0;15;1336
AT31;40411;Haigermoos;2018;595;32;1;0;1;629
AT31;40412;Handenberg;2018;1212;75;13;0;4;1304
AT31;40413;Helpfau-Uttendorf;2018;2780;552;253;19;42;3646
AT31;40414;Hochburg-Ach;2018;2471;702;13;1;66;3253
AT31;40415;Höhnhart;2018;1327;60;0;0;16;1403
AT31;40416;Jeging;2018;611;59;6;13;2;691
AT31;40417;Kirchberg bei Mattighofen;2018;1120;51;2;14;7;1194
AT31;40418;Lengau;2018;4242;293;125;52;30;4742
AT31;40419;Lochen am See;2018;2646;106;9;9;5;2775
AT31;40420;Maria Schmolln;2018;1350;36;0;1;15;1402
AT31;40421;Mattighofen;2018;4441;1022;983;133;161;6740
AT31;40422;Mauerkirchen;2018;1931;326;220;0;57;2534
AT31;40423;Mining;2018;1133;75;3;2;12;1225
AT31;40424;Moosbach;2018;924;106;12;0;9;1051
AT31;40425;Moosdorf;2018;1529;135;9;0;11;1684
AT31;40426;Munderfing;2018;2670;224;116;22;74;3106
AT31;40427;Neukirchen an der Enknach;2018;2075;108;26;2;39;2250
AT31;40428;Ostermiething;2018;2838;329;74;9;46;3296
AT31;40429;Palting;2018;921;27;9;0;6;963
AT31;40430;Perwang am Grabensee;2018;935;65;0;0;5;1005
AT31;40431;Pfaffstätt;2018;916;140;47;0;10;1113
AT31;40432;Pischelsdorf am Engelbach;2018;1508;138;8;6;15;1675
AT31;40433;Polling im Innkreis;2018;926;47;7;1;7;988
AT31;40434;Roßbach;2018;884;41;0;0;4;929
AT31;40435;St. Georgen am Fillmannsbach;2018;389;11;0;0;1;401
AT31;40436;St. Johann am Walde;2018;1918;115;3;1;9;2046
AT31;40437;St. Pantaleon;2018;2724;257;124;9;40;3154
AT31;40438;St. Peter am Hart;2018;2107;236;11;15;61;2430
AT31;40439;St. Radegund;2018;543;50;3;0;1;597
AT31;40440;St. Veit im Innkreis;2018;380;26;0;0;1;407
AT31;40441;Schalchen;2018;3350;291;247;18;26;3932
AT31;40442;Schwand im Innkreis;2018;933;48;6;0;9;996
AT31;40443;Tarsdorf;2018;1877;159;12;1;10;2059
AT31;40444;Treubach;2018;667;50;1;0;7;725
AT31;40445;Überackern;2018;478;194;0;0;4;676
AT31;40446;Weng im Innkreis;2018;1281;52;13;0;21;1367
AT31;40501;Alkoven;2018;5569;251;111;26;130;6087
AT31;40502;Aschach an der Donau;2018;1861;102;184;6;44;2197
AT31;40503;Eferding;2018;3371;201;411;22;122;4127
AT31;40504;Fraham;2018;2231;69;72;6;19;2397
AT31;40505;Haibach ob der Donau;2018;1275;26;1;0;12;1314
AT31;40506;Hartkirchen;2018;3921;44;52;5;45;4067
AT31;40507;Hinzenbach;2018;1908;51;71;3;18;2051
AT31;40508;Prambachkirchen;2018;2759;106;41;5;21;2932
AT31;40509;Pupping;2018;1725;37;36;2;16;1816
AT31;40510;St. Marienkirchen an der Polsenz;2018;2253;51;12;14;7;2337
AT31;40511;Scharten;2018;2148;43;32;0;22;2245
AT31;40512;Stroheim;2018;1558;24;0;1;3;1586
AT31;40601;Freistadt;2018;7230;215;51;240;224;7960
AT31;40602;Grünbach;2018;1882;25;0;2;15;1924
AT31;40603;Gutau;2018;2611;44;1;1;15;2672
AT31;40604;Hagenberg im Mühlkreis;2018;2648;70;4;1;28;2751
AT31;40605;Hirschbach im Mühlkreis;2018;1174;20;0;0;8;1202
AT31;40606;Kaltenberg;2018;613;8;0;0;1;622
AT31;40607;Kefermarkt;2018;2066;55;3;0;14;2138
AT31;40608;Königswiesen;2018;3068;17;1;0;5;3091
AT31;40609;Lasberg;2018;2711;40;2;10;33;2796
AT31;40610;Leopoldschlag;2018;967;15;0;10;23;1015
AT31;40611;Liebenau;2018;1575;7;1;0;2;1585
AT31;40612;Neumarkt im Mühlkreis;2018;3091;48;1;3;20;3163
AT31;40613;Pierbach;2018;999;11;0;0;6;1016
AT31;40614;Pregarten;2018;5160;151;39;10;62;5422
AT31;40615;Rainbach im Mühlkreis;2018;2857;75;0;20;37;2989
AT31;40616;Sandl;2018;1376;21;0;3;13;1413
AT31;40617;St. Leonhard bei Freistadt;2018;1363;19;0;0;6;1388
AT31;40618;St. Oswald bei Freistadt;2018;2800;54;7;4;41;2906
AT31;40619;Schönau im Mühlkreis;2018;1928;19;0;0;2;1949
AT31;40620;Tragwein;2018;3000;53;6;0;40;3099
AT31;40621;Unterweißenbach;2018;2145;17;1;5;6;2174
AT31;40622;Unterweitersdorf;2018;2110;30;3;2;16;2161
AT31;40623;Waldburg;2018;1366;15;0;0;1;1382
AT31;40624;Wartberg ob der Aist;2018;4158;79;5;2;32;4276
AT31;40625;Weitersfelden;2018;1005;39;0;0;3;1047
AT31;40626;Windhaag bei Freistadt;2018;1512;22;1;29;3;1567
AT31;40627;Bad Zell;2018;2834;36;14;7;22;2913
AT31;40701;Altmünster;2018;9076;519;77;13;97;9782
AT31;40702;Bad Goisern am Hallstättersee;2018;7078;389;22;7;71;7567
AT31;40703;Bad Ischl;2018;12263;1144;171;192;356;14126
AT31;40704;Ebensee am Traunsee;2018;7090;396;98;5;81;7670
AT31;40705;Gmunden;2018;10864;1243;589;73;389;13158
AT31;40706;Gosau;2018;1642;119;5;0;21;1787
AT31;40707;Grünau im Almtal;2018;1908;96;14;15;25;2058
AT31;40708;Gschwandt;2018;2657;75;26;1;15;2774
AT31;40709;Hallstatt;2018;636;89;13;4;12;754
AT31;40710;Kirchham;2018;2082;61;3;18;9;2173
AT31;40711;Laakirchen;2018;8389;523;740;54;135;9841
AT31;40712;Obertraun;2018;620;84;0;0;31;735
AT31;40713;Ohlsdorf;2018;4913;204;99;15;12;5243
AT31;40714;Pinsdorf;2018;3530;286;140;10;37;4003
AT31;40715;Roitham am Traunfall;2018;1895;86;9;4;12;2006
AT31;40716;St. Konrad;2018;1081;44;1;0;2;1128
AT31;40717;St. Wolfgang im Salzkammergut;2018;2512;164;48;1;32;2757
AT31;40718;Traunkirchen;2018;1548;72;15;7;18;1660
AT31;40719;Scharnstein;2018;4490;255;69;27;49;4890
AT31;40720;Vorchdorf;2018;6830;288;194;138;69;7519
AT31;40801;Aistersheim;2018;847;43;7;0;5;902
AT31;40802;Bad Schallerbach;2018;3536;408;189;15;71;4219
AT31;40804;Eschenau im Hausruckkreis;2018;1046;13;0;0;2;1061
AT31;40805;Gallspach;2018;2111;326;187;62;42;2728
AT31;40806;Gaspoltshofen;2018;3309;182;36;19;35;3581
AT31;40807;Geboltskirchen;2018;1372;42;2;0;32;1448
AT31;40808;Grieskirchen;2018;4085;313;160;265;134;4957
AT31;40809;Haag am Hausruck;2018;1967;128;73;9;31;2208
AT31;40810;Heiligenberg;2018;677;21;0;0;0;698
AT31;40811;Hofkirchen an der Trattnach;2018;1492;104;48;0;19;1663
AT31;40812;Kallham;2018;2394;62;20;11;5;2492
AT31;40813;Kematen am Innbach;2018;1288;71;14;20;9;1402
AT31;40814;Meggenhofen;2018;1469;40;0;4;20;1533
AT31;40815;Michaelnbach;2018;1240;26;0;1;7;1274
AT31;40816;Natternbach;2018;2234;44;0;0;23;2301
AT31;40817;Neukirchen am Walde;2018;1588;34;6;0;5;1633
AT31;40818;Neumarkt im Hausruckkreis;2018;1241;74;25;90;10;1440
AT31;40820;Pötting;2018;536;4;0;0;0;540
AT31;40821;Pollham;2018;949;14;0;0;11;974
AT31;40822;Pram;2018;1620;61;8;3;10;1702
AT31;40823;Rottenbach;2018;1036;52;14;0;6;1108
AT31;40824;St. Agatha;2018;2089;23;0;0;8;2120
AT31;40825;St. Georgen bei Grieskirchen;2018;1297;24;3;7;1;1332
AT31;40826;St. Thomas;2018;531;16;0;0;1;548
AT31;40827;Schlüßlberg;2018;2801;108;44;64;33;3050
AT31;40828;Steegen;2018;1049;9;8;0;5;1071
AT31;40829;Taufkirchen an der Trattnach;2018;1894;52;11;0;7;1964
AT31;40830;Tollet;2018;895;22;0;0;7;924
AT31;40831;Waizenkirchen;2018;3455;129;88;30;33;3735
AT31;40832;Wallern an der Trattnach;2018;2805;140;31;22;20;3018
AT31;40833;Weibern;2018;1558;61;63;0;33;1715
AT31;40834;Wendling;2018;836;6;0;5;2;849
AT31;40835;Peuerbach;2018;4234;164;44;36;53;4531
AT31;40901;Edlbach;2018;596;31;8;0;20;655
AT31;40902;Grünburg;2018;3463;139;81;125;47;3855
AT31;40903;Hinterstoder;2018;791;82;7;0;26;906
AT31;40904;Inzersdorf im Kremstal;2018;1785;59;12;9;10;1875
AT31;40905;Kirchdorf an der Krems;2018;3798;357;187;58;103;4503
AT31;40906;Klaus an der Pyhrnbahn;2018;934;97;3;0;17;1051
AT31;40907;Kremsmünster;2018;5521;694;252;20;91;6578
AT31;40908;Micheldorf in Oberösterreich;2018;5306;253;166;83;80;5888
AT31;40909;Molln;2018;3285;107;81;124;51;3648
AT31;40910;Nußbach;2018;2209;66;7;0;7;2289
AT31;40911;Oberschlierbach;2018;474;15;1;0;1;491
AT31;40912;Pettenbach;2018;4872;223;65;94;49;5303
AT31;40913;Ried im Traunkreis;2018;2561;122;17;13;11;2724
AT31;40914;Rosenau am Hengstpaß;2018;579;45;27;0;14;665
AT31;40915;Roßleithen;2018;1811;61;26;1;9;1908
AT31;40916;St. Pankraz;2018;327;25;4;0;7;363
AT31;40917;Schlierbach;2018;2634;114;34;6;83;2871
AT31;40918;Spital am Pyhrn;2018;2071;115;25;1;22;2234
AT31;40919;Steinbach am Ziehberg;2018;822;15;2;0;2;841
AT31;40920;Steinbach an der Steyr;2018;1918;43;10;11;11;1993
AT31;40921;Vorderstoder;2018;775;41;0;0;2;818
AT31;40922;Wartberg an der Krems;2018;2736;133;39;32;55;2995
AT31;40923;Windischgarsten;2018;2101;165;95;1;50;2412
AT31;41001;Allhaming;2018;1106;44;2;11;13;1176
AT31;41002;Ansfelden;2018;12746;1721;950;525;712;16654
AT31;41003;Asten;2018;5678;533;205;140;134;6690
AT31;41004;Eggendorf im Traunkreis;2018;902;39;1;5;3;950
AT31;41005;Enns;2018;9404;1320;880;201;230;12035
AT31;41006;Hargelsberg;2018;1334;41;2;0;11;1388
AT31;41007;Hörsching;2018;5348;527;130;71;58;6134
AT31;41008;Hofkirchen im Traunkreis;2018;1748;120;3;1;24;1896
AT31;41009;Kematen an der Krems;2018;2575;166;49;25;42;2857
AT31;41010;Kirchberg-Thening;2018;2298;75;13;2;26;2414
AT31;41011;Kronstorf;2018;3153;239;91;11;14;3508
AT31;41012;Leonding;2018;24695;2153;791;285;871;28795
AT31;41013;St. Florian;2018;5853;255;28;4;45;6185
AT31;41014;Neuhofen an der Krems;2018;5890;335;159;26;111;6521
AT31;41015;Niederneukirchen;2018;2010;60;13;0;13;2096
AT31;41016;Oftering;2018;2025;54;30;5;11;2125
AT31;41017;Pasching;2018;6444;630;210;143;180;7607
AT31;41018;Piberbach;2018;1803;61;8;2;14;1888
AT31;41019;Pucking;2018;3722;162;51;20;16;3971
AT31;41020;St. Marien;2018;4535;163;34;22;31;4785
AT31;41021;Traun;2018;18619;2668;1879;636;848;24650
AT31;41022;Wilhering;2018;5517;244;62;15;110;5948
AT31;41101;Allerheiligen im Mühlkreis;2018;1237;16;2;0;25;1280
AT31;41102;Arbing;2018;1394;57;10;11;8;1480
AT31;41103;Baumgartenberg;2018;1631;52;5;7;55;1750
AT31;41104;Dimbach;2018;983;4;0;0;4;991
AT31;41105;Grein;2018;2654;164;18;1;65;2902
AT31;41106;Katsdorf;2018;2986;116;3;0;35;3140
AT31;41107;Klam;2018;916;20;0;2;0;938
AT31;41108;Bad Kreuzen;2018;2133;19;7;7;59;2225
AT31;41109;Langenstein;2018;2291;123;14;30;71;2529
AT31;41110;Luftenberg an der Donau;2018;3909;167;49;19;63;4207
AT31;41111;Mauthausen;2018;4181;289;114;211;95;4890
AT31;41112;Mitterkirchen im Machland;2018;1627;54;13;10;16;1720
AT31;41113;Münzbach;2018;1620;168;17;2;20;1827
AT31;41114;Naarn im Machlande;2018;3397;153;48;65;48;3711
AT31;41115;Pabneukirchen;2018;1648;18;9;0;27;1702
AT31;41116;Perg;2018;7368;569;318;265;122;8642
AT31;41117;Rechberg;2018;968;33;0;0;1;1002
AT31;41118;Ried in der Riedmark;2018;4104;79;3;6;67;4259
AT31;41119;St. Georgen am Walde;2018;1940;11;0;0;4;1955
AT31;41120;St. Georgen an der Gusen;2018;3868;129;20;56;104;4177
AT31;41121;St. Nikola an der Donau;2018;616;44;8;10;101;779
AT31;41122;St. Thomas am Blasenstein;2018;902;12;6;0;4;924
AT31;41123;Saxen;2018;1637;77;14;16;26;1770
AT31;41124;Schwertberg;2018;4647;356;73;135;66;5277
AT31;41125;Waldhausen im Strudengau;2018;2749;47;11;1;74;2882
AT31;41126;Windhaag bei Perg;2018;1370;91;28;5;6;1500
AT31;41201;Andrichsfurt;2018;730;41;1;2;3;777
AT31;41202;Antiesenhofen;2018;917;110;41;6;18;1092
AT31;41203;Aurolzmünster;2018;2642;200;91;68;34;3035
AT31;41204;Eberschwang;2018;3164;131;71;3;45;3414
AT31;41205;Eitzing;2018;778;26;1;4;2;811
AT31;41206;Geiersberg;2018;493;6;3;0;0;502
AT31;41207;Geinberg;2018;1226;132;18;7;13;1396
AT31;41208;Gurten;2018;1101;66;13;2;16;1198
AT31;41209;Hohenzell;2018;2135;78;38;6;6;2263
AT31;41210;Kirchdorf am Inn;2018;574;63;6;3;8;654
AT31;41211;Kirchheim im Innkreis;2018;702;17;1;0;4;724
AT31;41212;Lambrechten;2018;1248;60;5;1;4;1318
AT31;41213;Lohnsburg am Kobernaußerwald;2018;2153;79;0;0;12;2244
AT31;41214;Mehrnbach;2018;2171;76;61;10;43;2361
AT31;41215;Mettmach;2018;2277;54;0;1;21;2353
AT31;41216;Mörschwang;2018;308;26;0;0;1;335
AT31;41217;Mühlheim am Inn;2018;607;54;0;0;8;669
AT31;41218;Neuhofen im Innkreis;2018;2265;106;38;15;25;2449
AT31;41219;Obernberg am Inn;2018;1257;355;34;5;10;1661
AT31;41220;Ort im Innkreis;2018;1111;103;19;23;13;1269
AT31;41221;Pattigham;2018;924;28;3;1;6;962
AT31;41222;Peterskirchen;2018;682;15;0;4;0;701
AT31;41223;Pramet;2018;975;34;6;1;0;1016
AT31;41224;Reichersberg;2018;1332;135;27;10;14;1518
AT31;41225;Ried im Innkreis;2018;9358;1105;515;569;508;12055
AT31;41226;St. Georgen bei Obernberg am Inn;2018;508;44;2;0;12;566
AT31;41227;St. Marienkirchen am Hausruck;2018;847;16;5;0;2;870
AT31;41228;St. Martin im Innkreis;2018;1604;330;82;10;20;2046
AT31;41229;Schildorn;2018;1165;33;0;0;17;1215
AT31;41230;Senftenbach;2018;704;46;8;10;10;778
AT31;41231;Taiskirchen im Innkreis;2018;2310;79;3;1;8;2401
AT31;41232;Tumeltsham;2018;1486;45;43;13;7;1594
AT31;41233;Utzenaich;2018;1432;94;20;4;3;1553
AT31;41234;Waldzell;2018;2108;73;0;4;24;2209
AT31;41235;Weilbach;2018;583;38;0;0;1;622
AT31;41236;Wippenham;2018;541;16;0;1;15;573
AT31;41304;Altenfelden;2018;2151;17;3;11;48;2230
AT31;41305;Arnreit;2018;1130;5;11;0;6;1152
AT31;41306;Atzesberg;2018;433;6;0;0;1;440
AT31;41307;Auberg;2018;542;14;0;0;2;558
AT31;41309;Haslach an der Mühl;2018;2388;64;14;20;54;2540
AT31;41311;Hörbich;2018;394;4;1;0;7;406
AT31;41312;Hofkirchen im Mühlkreis;2018;1445;49;0;4;18;1516
AT31;41313;Julbach;2018;1493;55;0;0;4;1552
AT31;41314;Kirchberg ob der Donau;2018;1023;18;0;0;4;1045
AT31;41315;Klaffer am Hochficht;2018;1214;50;0;0;28;1292
AT31;41316;Kleinzell im Mühlkreis;2018;1565;19;0;5;7;1596
AT31;41317;Kollerschlag;2018;1445;49;0;2;6;1502
AT31;41318;Lembach im Mühlkreis;2018;1435;32;28;2;41;1538
AT31;41319;Lichtenau im Mühlkreis;2018;466;10;1;0;13;490
AT31;41320;Nebelberg;2018;618;19;0;0;1;638
AT31;41321;Neufelden;2018;1097;46;49;1;88;1281
AT31;41322;Niederkappel;2018;970;16;0;0;5;991
AT31;41323;Niederwaldkirchen;2018;1790;39;0;6;12;1847
AT31;41324;Oberkappel;2018;633;44;0;0;35;712
AT31;41325;Oepping;2018;1497;19;4;3;0;1523
AT31;41326;Peilstein im Mühlviertel;2018;1510;24;0;0;9;1543
AT31;41327;Pfarrkirchen im Mühlkreis;2018;1385;59;0;0;21;1465
AT31;41328;Putzleinsdorf;2018;1478;31;11;0;18;1538
AT31;41329;Neustift im Mühlkreis;2018;1374;59;0;0;31;1464
AT31;41331;St. Johann am Wimberg;2018;984;24;1;2;5;1016
AT31;41332;St. Martin im Mühlkreis;2018;3618;61;3;36;60;3778
AT31;41333;St. Oswald bei Haslach;2018;487;15;0;0;1;503
AT31;41334;St. Peter am Wimberg;2018;1721;25;0;1;15;1762
AT31;41336;St. Ulrich im Mühlkreis;2018;631;5;0;0;1;637
AT31;41337;St. Veit im Mühlkreis;2018;1196;21;4;0;6;1227
AT31;41338;Sarleinsbach;2018;2226;37;2;1;10;2276
AT31;41341;Schwarzenberg am Böhmerwald;2018;498;70;1;0;8;577
AT31;41342;Ulrichsberg;2018;2676;112;0;0;41;2829
AT31;41343;Aigen-Schlägl;2018;3025;100;29;0;62;3216
AT31;41344;Rohrbach-Berg;2018;4773;173;60;16;138;5160
AT31;41345;Helfenberg;2018;1498;28;4;6;48;1584
AT31;41346;St. Stefan-Afiesl;2018;1070;21;0;0;9;1100
AT31;41401;Altschwendt;2018;669;13;0;2;13;697
AT31;41402;Andorf;2018;4824;172;64;86;58;5204
AT31;41403;Brunnenthal;2018;1869;162;11;9;22;2073
AT31;41404;Diersbach;2018;1524;43;1;0;26;1594
AT31;41405;Dorf an der Pram;2018;1004;24;5;4;11;1048
AT31;41406;Eggerding;2018;1270;43;0;3;5;1321
AT31;41407;Engelhartszell;2018;837;66;4;0;17;924
AT31;41408;Enzenkirchen;2018;1703;55;1;0;15;1774
AT31;41409;Esternberg;2018;2691;155;1;1;9;2857
AT31;41410;Freinberg;2018;1093;353;1;0;5;1452
AT31;41411;Kopfing im Innkreis;2018;1909;52;0;0;41;2002
AT31;41412;Mayrhof;2018;317;11;0;0;2;330
AT31;41413;Münzkirchen;2018;2460;73;7;0;20;2560
AT31;41414;Raab;2018;2116;90;2;26;42;2276
AT31;41415;Rainbach im Innkreis;2018;1434;30;0;9;12;1485
AT31;41416;Riedau;2018;1867;112;20;52;21;2072
AT31;41417;St. Aegidi;2018;1511;29;0;0;8;1548
AT31;41418;St. Florian am Inn;2018;2787;243;13;67;73;3183
AT31;41419;St. Marienkirchen bei Schärding;2018;1744;110;1;28;10;1893
AT31;41420;St. Roman;2018;1677;37;0;0;0;1714
AT31;41421;St. Willibald;2018;1060;31;1;0;2;1094
AT31;41422;Schärding;2018;4065;535;146;183;291;5220
AT31;41423;Schardenberg;2018;2072;340;8;0;18;2438
AT31;41424;Sigharting;2018;792;26;0;3;4;825
AT31;41425;Suben;2018;1181;132;39;35;81;1468
AT31;41426;Taufkirchen an der Pram;2018;2687;105;5;63;34;2894
AT31;41427;Vichtenstein;2018;524;83;0;0;12;619
AT31;41428;Waldkirchen am Wesen;2018;1160;30;0;0;7;1197
AT31;41429;Wernstein am Inn;2018;1364;135;2;1;24;1526
AT31;41430;Zell an der Pram;2018;1879;84;12;28;16;2019
AT31;41501;Adlwang;2018;1802;51;3;5;15;1876
AT31;41502;Aschach an der Steyr;2018;2240;23;11;0;13;2287
AT31;41503;Bad Hall;2018;4637;408;105;80;145;5375
AT31;41504;Dietach;2018;2974;134;81;7;44;3240
AT31;41505;Gaflenz;2018;1866;54;7;0;23;1950
AT31;41506;Garsten;2018;6239;181;64;23;137;6644
AT31;41507;Großraming;2018;2597;37;2;0;38;2674
AT31;41508;Laussa;2018;1236;13;0;0;2;1251
AT31;41509;Losenstein;2018;1514;71;8;0;10;1603
AT31;41510;Maria Neustift;2018;1584;13;0;0;8;1605
AT31;41511;Pfarrkirchen bei Bad Hall;2018;2151;85;12;4;32;2284
AT31;41512;Reichraming;2018;1638;46;5;0;16;1705
AT31;41513;Rohr im Kremstal;2018;1299;57;26;5;17;1404
AT31;41514;St. Ulrich bei Steyr;2018;2920;59;21;1;21;3022
AT31;41515;Schiedlberg;2018;1144;55;5;1;13;1218
AT31;41516;Sierning;2018;8468;415;227;105;114;9329
AT31;41517;Ternberg;2018;3271;82;4;2;47;3406
AT31;41518;Waldneukirchen;2018;2092;51;20;13;18;2194
AT31;41521;Wolfern;2018;3090;60;6;1;6;3163
AT31;41522;Weyer;2018;3916;138;20;7;116;4197
AT31;41601;Alberndorf in der Riedmark;2018;4011;87;7;0;37;4142
AT31;41602;Altenberg bei Linz;2018;4461;94;2;1;43;4601
AT31;41603;Bad Leonfelden;2018;3954;132;25;26;108;4245
AT31;41604;Eidenberg;2018;2032;47;1;0;17;2097
AT31;41605;Engerwitzdorf;2018;8431;222;33;3;122;8811
AT31;41606;Feldkirchen an der Donau;2018;5109;117;66;14;74;5380
AT31;41607;Gallneukirchen;2018;6016;247;63;19;158;6503
AT31;41608;Goldwörth;2018;809;9;3;0;14;835
AT31;41609;Gramastetten;2018;4928;139;5;8;56;5136
AT31;41610;Haibach im Mühlkreis;2018;888;28;0;0;3;919
AT31;41611;Hellmonsödt;2018;2198;87;7;11;34;2337
AT31;41612;Herzogsdorf;2018;2531;32;0;1;7;2571
AT31;41613;Kirchschlag bei Linz;2018;2032;104;5;0;33;2174
AT31;41614;Lichtenberg;2018;2585;57;0;1;24;2667
AT31;41615;Oberneukirchen;2018;3082;59;9;2;39;3191
AT31;41616;Ottenschlag im Mühlkreis;2018;533;8;0;0;3;544
AT31;41617;Ottensheim;2018;4369;213;37;11;137;4767
AT31;41618;Puchenau;2018;4173;170;14;3;93;4453
AT31;41619;Reichenau im Mühlkreis;2018;1225;55;0;0;22;1302
AT31;41620;Reichenthal;2018;1474;33;4;1;7;1519
AT31;41621;St. Gotthard im Mühlkreis;2018;1243;36;0;0;25;1304
AT31;41622;Schenkenfelden;2018;1547;13;4;0;23;1587
AT31;41623;Sonnberg im Mühlkreis;2018;976;15;0;0;4;995
AT31;41624;Steyregg;2018;4498;248;64;2;76;4888
AT31;41626;Walding;2018;3929;101;15;13;86;4144
AT31;41627;Zwettl an der Rodl;2018;1647;34;0;8;64;1753
AT31;41628;Vorderweißenbach;2018;2582;40;3;5;10;2640
AT31;41701;Ampflwang im Hausruckwald;2018;2932;291;52;21;54;3350
AT31;41702;Attersee am Attersee;2018;1449;98;1;0;35;1583
AT31;41703;Attnang-Puchheim;2018;6535;1087;739;329;352;9042
AT31;41704;Atzbach;2018;1142;62;0;0;3;1207
AT31;41705;Aurach am Hongar;2018;1661;43;7;4;14;1729
AT31;41706;Berg im Attergau;2018;1022;31;1;0;5;1059
AT31;41707;Desselbrunn;2018;1752;61;11;0;9;1833
AT31;41708;Fornach;2018;947;39;0;0;1;987
AT31;41709;Frankenburg am Hausruck;2018;4618;197;57;7;10;4889
AT31;41710;Frankenmarkt;2018;3155;341;80;45;44;3665
AT31;41711;Gampern;2018;2845;81;20;0;19;2965
AT31;41712;Innerschwand am Mondsee;2018;1100;65;3;1;7;1176
AT31;41713;Lenzing;2018;4509;349;158;27;116;5159
AT31;41714;Manning;2018;785;12;1;0;2;800
AT31;41715;Mondsee;2018;2955;546;176;12;88;3777
AT31;41716;Neukirchen an der Vöckla;2018;2522;82;8;0;11;2623
AT31;41717;Niederthalheim;2018;1039;46;1;13;18;1117
AT31;41718;Nußdorf am Attersee;2018;1012;83;13;0;18;1126
AT31;41719;Oberhofen am Irrsee;2018;1538;105;9;1;13;1666
AT31;41720;Oberndorf bei Schwanenstadt;2018;1269;43;36;3;24;1375
AT31;41721;Oberwang;2018;1663;67;5;0;7;1742
AT31;41722;Ottnang am Hausruck;2018;3656;246;9;4;37;3952
AT31;41723;Pfaffing;2018;1417;39;1;0;10;1467
AT31;41724;Pilsbach;2018;606;12;0;1;2;621
AT31;41725;Pitzenberg;2018;525;5;0;1;2;533
AT31;41726;Pöndorf;2018;2248;124;11;15;10;2408
AT31;41727;Puchkirchen am Trattberg;2018;1018;54;5;0;3;1080
AT31;41728;Pühret;2018;604;8;2;0;0;614
AT31;41729;Redleiten;2018;491;30;0;2;11;534
AT31;41730;Redlham;2018;1499;62;27;2;6;1596
AT31;41731;Regau;2018;6042;384;158;12;104;6700
AT31;41732;Rüstorf;2018;1952;74;59;3;15;2103
AT31;41733;Rutzenham;2018;284;8;4;0;0;296
AT31;41734;St. Georgen im Attergau;2018;3783;334;152;30;141;4440
AT31;41735;St. Lorenz;2018;2292;169;15;11;29;2516
AT31;41736;Schlatt;2018;1272;67;11;9;9;1368
AT31;41737;Schörfling am Attersee;2018;3189;200;39;0;31;3459
AT31;41738;Schwanenstadt;2018;3474;414;283;68;151;4390
AT31;41739;Seewalchen am Attersee;2018;5250;275;57;3;50;5635
AT31;41740;Steinbach am Attersee;2018;795;77;1;0;9;882
AT31;41741;Straß im Attergau;2018;1370;72;15;4;31;1492
AT31;41742;Tiefgraben;2018;3582;311;23;4;67;3987
AT31;41743;Timelkam;2018;5031;276;181;29;155;5672
AT31;41744;Ungenach;2018;1437;52;1;1;9;1500
AT31;41745;Unterach am Attersee;2018;1272;130;36;1;23;1462
AT31;41746;Vöcklabruck;2018;10045;898;590;96;695;12324
AT31;41747;Vöcklamarkt;2018;4374;280;156;55;85;4950
AT31;41748;Weißenkirchen im Attergau;2018;937;32;1;0;0;970
AT31;41749;Weyregg am Attersee;2018;1504;69;4;0;12;1589
AT31;41750;Wolfsegg am Hausruck;2018;1763;185;3;6;27;1984
AT31;41751;Zell am Moos;2018;1464;85;15;9;37;1610
AT31;41752;Zell am Pettenfirst;2018;1192;38;3;1;15;1249
AT31;41801;Aichkirchen;2018;570;16;2;4;2;594
AT31;41802;Bachmanning;2018;621;76;11;11;2;721
AT31;41803;Bad Wimsbach-Neydharting;2018;2418;76;30;24;18;2566
AT31;41804;Buchkirchen;2018;3882;130;21;13;19;4065
AT31;41805;Eberstalzell;2018;2490;81;48;4;30;2653
AT31;41806;Edt bei Lambach;2018;2067;123;52;7;16;2265
AT31;41807;Fischlham;2018;1293;41;1;2;4;1341
AT31;41808;Gunskirchen;2018;5538;460;106;10;24;6138
AT31;41809;Holzhausen;2018;963;51;7;1;3;1025
AT31;41810;Krenglbach;2018;2996;123;28;10;22;3179
AT31;41811;Lambach;2018;2724;407;251;29;112;3523
AT31;41812;Marchtrenk;2018;11588;1323;401;259;231;13802
AT31;41813;Neukirchen bei Lambach;2018;882;24;4;2;6;918
AT31;41814;Offenhausen;2018;1547;117;12;21;6;1703
AT31;41815;Pennewang;2018;883;32;0;0;1;916
AT31;41816;Pichl bei Wels;2018;2673;159;22;53;23;2930
AT31;41817;Sattledt;2018;2355;177;68;78;34;2712
AT31;41818;Schleißheim;2018;1309;73;4;8;12;1406
AT31;41819;Sipbachzell;2018;1924;65;11;12;13;2025
AT31;41820;Stadl-Paura;2018;4114;399;342;59;123;5037
AT31;41821;Steinerkirchen an der Traun;2018;2283;76;11;0;15;2385
AT31;41822;Steinhaus;2018;2105;91;11;1;18;2226
AT31;41823;Thalheim bei Wels;2018;4884;404;133;25;80;5526
AT31;41824;Weißkirchen an der Traun;2018;3183;174;22;19;40;3438
AT31;40101;Linz;2017;158307;18183;11596;3520;13240;204846
AT31;40201;Steyr;2017;31167;2498;2396;933;1337;38331
AT31;40301;Wels;2017;45770;6000;5397;1638;2428;61233
AT31;40401;Altheim;2017;4247;386;158;14;34;4839
AT31;40402;Aspach;2017;2375;194;15;0;12;2596
AT31;40403;Auerbach;2017;538;33;7;0;5;583
AT31;40404;Braunau am Inn;2017;13124;1856;1113;150;852;17095
AT31;40405;Burgkirchen;2017;2424;155;62;1;19;2661
AT31;40406;Eggelsberg;2017;2146;161;27;6;25;2365
AT31;40407;Feldkirchen bei Mattighofen;2017;1866;89;10;0;13;1978
AT31;40408;Franking;2017;857;87;7;0;2;953
AT31;40409;Geretsberg;2017;1064;86;4;0;33;1187
AT31;40410;Gilgenberg am Weilhart;2017;1204;106;5;0;12;1327
AT31;40411;Haigermoos;2017;578;29;1;0;2;610
AT31;40412;Handenberg;2017;1201;72;12;0;5;1290
AT31;40413;Helpfau-Uttendorf;2017;2801;448;263;16;45;3573
AT31;40414;Hochburg-Ach;2017;2472;688;13;1;62;3236
AT31;40415;Höhnhart;2017;1311;57;0;0;11;1379
AT31;40416;Jeging;2017;605;61;6;18;1;691
AT31;40417;Kirchberg bei Mattighofen;2017;1105;49;0;14;7;1175
AT31;40418;Lengau;2017;4252;251;133;56;46;4738
AT31;40419;Lochen am See;2017;2645;83;11;9;6;2754
AT31;40420;Maria Schmolln;2017;1361;37;0;1;15;1414
AT31;40421;Mattighofen;2017;4424;854;964;125;157;6524
AT31;40422;Mauerkirchen;2017;1929;342;238;0;57;2566
AT31;40423;Mining;2017;1117;67;4;2;5;1195
AT31;40424;Moosbach;2017;930;99;6;0;7;1042
AT31;40425;Moosdorf;2017;1501;112;9;0;16;1638
AT31;40426;Munderfing;2017;2673;204;108;24;54;3063
AT31;40427;Neukirchen an der Enknach;2017;2050;100;26;2;34;2212
AT31;40428;Ostermiething;2017;2825;332;77;9;53;3296
AT31;40429;Palting;2017;902;25;6;0;5;938
AT31;40430;Perwang am Grabensee;2017;927;64;0;0;6;997
AT31;40431;Pfaffstätt;2017;916;127;45;0;13;1101
AT31;40432;Pischelsdorf am Engelbach;2017;1508;135;7;6;16;1672
AT31;40433;Polling im Innkreis;2017;923;57;7;0;10;997
AT31;40434;Roßbach;2017;895;37;0;0;3;935
AT31;40435;St. Georgen am Fillmannsbach;2017;389;13;1;0;1;404
AT31;40436;St. Johann am Walde;2017;1939;100;2;1;9;2051
AT31;40437;St. Pantaleon;2017;2694;237;113;9;32;3085
AT31;40438;St. Peter am Hart;2017;2126;229;13;11;68;2447
AT31;40439;St. Radegund;2017;535;51;3;0;0;589
AT31;40440;St. Veit im Innkreis;2017;383;24;0;0;1;408
AT31;40441;Schalchen;2017;3346;255;235;14;27;3877
AT31;40442;Schwand im Innkreis;2017;915;42;6;0;9;972
AT31;40443;Tarsdorf;2017;1888;159;13;1;7;2068
AT31;40444;Treubach;2017;674;43;1;0;7;725
AT31;40445;Überackern;2017;494;188;0;0;3;685
AT31;40446;Weng im Innkreis;2017;1297;55;18;0;24;1394
AT31;40501;Alkoven;2017;5482;225;106;27;121;5961
AT31;40502;Aschach an der Donau;2017;1870;93;181;3;54;2201
AT31;40503;Eferding;2017;3353;189;407;23;128;4100
AT31;40504;Fraham;2017;2228;69;66;6;26;2395
AT31;40505;Haibach ob der Donau;2017;1271;23;1;0;13;1308
AT31;40506;Hartkirchen;2017;3928;43;62;5;61;4099
AT31;40507;Hinzenbach;2017;1866;37;69;3;24;1999
AT31;40508;Prambachkirchen;2017;2755;92;38;6;28;2919
AT31;40509;Pupping;2017;1743;36;27;2;16;1824
AT31;40510;St. Marienkirchen an der Polsenz;2017;2240;53;13;18;13;2337
AT31;40511;Scharten;2017;2156;43;36;0;17;2252
AT31;40512;Stroheim;2017;1533;18;0;1;3;1555
AT31;40601;Freistadt;2017;7200;206;48;231;224;7909
AT31;40602;Grünbach;2017;1884;24;0;2;36;1946
AT31;40603;Gutau;2017;2643;42;1;0;38;2724
AT31;40604;Hagenberg im Mühlkreis;2017;2644;66;1;0;26;2737
AT31;40605;Hirschbach im Mühlkreis;2017;1168;17;0;0;9;1194
AT31;40606;Kaltenberg;2017;618;7;0;0;0;625
AT31;40607;Kefermarkt;2017;2027;51;7;0;31;2116
AT31;40608;Königswiesen;2017;3087;16;1;0;9;3113
AT31;40609;Lasberg;2017;2680;37;2;11;18;2748
AT31;40610;Leopoldschlag;2017;965;19;1;12;26;1023
AT31;40611;Liebenau;2017;1585;9;1;0;2;1597
AT31;40612;Neumarkt im Mühlkreis;2017;3087;51;1;2;22;3163
AT31;40613;Pierbach;2017;994;11;0;0;6;1011
AT31;40614;Pregarten;2017;5061;122;40;9;61;5293
AT31;40615;Rainbach im Mühlkreis;2017;2834;65;0;21;39;2959
AT31;40616;Sandl;2017;1351;19;0;4;10;1384
AT31;40617;St. Leonhard bei Freistadt;2017;1368;20;0;0;6;1394
AT31;40618;St. Oswald bei Freistadt;2017;2790;51;8;4;48;2901
AT31;40619;Schönau im Mühlkreis;2017;1921;17;0;0;3;1941
AT31;40620;Tragwein;2017;2988;49;6;2;37;3082
AT31;40621;Unterweißenbach;2017;2171;13;0;5;3;2192
AT31;40622;Unterweitersdorf;2017;2033;26;3;2;18;2082
AT31;40623;Waldburg;2017;1357;17;0;0;1;1375
AT31;40624;Wartberg ob der Aist;2017;4103;72;6;1;40;4222
AT31;40625;Weitersfelden;2017;1002;37;0;0;3;1042
AT31;40626;Windhaag bei Freistadt;2017;1522;16;1;30;10;1579
AT31;40627;Bad Zell;2017;2818;38;17;6;40;2919
AT31;40701;Altmünster;2017;9123;461;90;12;107;9793
AT31;40702;Bad Goisern am Hallstättersee;2017;6996;360;23;7;64;7450
AT31;40703;Bad Ischl;2017;12307;1103;172;202;349;14133
AT31;40704;Ebensee am Traunsee;2017;7165;346;103;4;99;7717
AT31;40705;Gmunden;2017;11006;1135;590;74;386;13191
AT31;40706;Gosau;2017;1650;116;5;0;21;1792
AT31;40707;Grünau im Almtal;2017;1919;94;13;16;22;2064
AT31;40708;Gschwandt;2017;2638;71;28;1;12;2750
AT31;40709;Hallstatt;2017;661;95;11;0;11;778
AT31;40710;Kirchham;2017;2059;51;3;18;8;2139
AT31;40711;Laakirchen;2017;8435;497;731;54;144;9861
AT31;40712;Obertraun;2017;629;68;1;0;28;726
AT31;40713;Ohlsdorf;2017;4865;183;92;15;54;5209
AT31;40714;Pinsdorf;2017;3426;248;134;12;29;3849
AT31;40715;Roitham am Traunfall;2017;1901;73;8;4;15;2001
AT31;40716;St. Konrad;2017;1077;35;1;0;2;1115
AT31;40717;St. Wolfgang im Salzkammergut;2017;2513;167;55;1;34;2770
AT31;40718;Traunkirchen;2017;1514;69;17;7;17;1624
AT31;40719;Scharnstein;2017;4452;227;67;23;50;4819
AT31;40720;Vorchdorf;2017;6835;251;179;141;69;7475
AT31;40801;Aistersheim;2017;838;42;7;0;5;892
AT31;40802;Bad Schallerbach;2017;3549;350;187;17;66;4169
AT31;40804;Eschenau im Hausruckkreis;2017;1046;15;0;0;2;1063
AT31;40805;Gallspach;2017;2115;303;178;62;114;2772
AT31;40806;Gaspoltshofen;2017;3309;155;38;20;44;3566
AT31;40807;Geboltskirchen;2017;1364;38;0;0;19;1421
AT31;40808;Grieskirchen;2017;4104;334;144;274;146;5002
AT31;40809;Haag am Hausruck;2017;1952;115;68;3;38;2176
AT31;40810;Heiligenberg;2017;670;21;0;0;0;691
AT31;40811;Hofkirchen an der Trattnach;2017;1499;99;46;0;23;1667
AT31;40812;Kallham;2017;2403;52;24;12;7;2498
AT31;40813;Kematen am Innbach;2017;1296;71;16;17;13;1413
AT31;40814;Meggenhofen;2017;1452;39;0;4;19;1514
AT31;40815;Michaelnbach;2017;1230;20;0;0;13;1263
AT31;40816;Natternbach;2017;2241;41;0;0;23;2305
AT31;40817;Neukirchen am Walde;2017;1585;33;9;0;6;1633
AT31;40818;Neumarkt im Hausruckkreis;2017;1263;74;24;93;11;1465
AT31;40820;Pötting;2017;537;4;0;0;0;541
AT31;40821;Pollham;2017;952;20;0;0;12;984
AT31;40822;Pram;2017;1631;53;9;2;13;1708
AT31;40823;Rottenbach;2017;1036;52;11;1;5;1105
AT31;40824;St. Agatha;2017;2086;27;0;0;3;2116
AT31;40825;St. Georgen bei Grieskirchen;2017;1294;30;3;7;2;1336
AT31;40826;St. Thomas;2017;532;12;0;0;1;545
AT31;40827;Schlüßlberg;2017;2852;114;44;54;27;3091
AT31;40828;Steegen;2017;1029;11;8;0;1;1049
AT31;40829;Taufkirchen an der Trattnach;2017;1910;48;7;0;5;1970
AT31;40830;Tollet;2017;895;22;0;0;3;920
AT31;40831;Waizenkirchen;2017;3442;141;84;31;31;3729
AT31;40832;Wallern an der Trattnach;2017;2830;133;31;25;20;3039
AT31;40833;Weibern;2017;1559;62;62;0;34;1717
AT31;40834;Wendling;2017;825;6;0;5;2;838
AT31;40835;Peuerbach;2017;4206;144;42;43;48;4483
AT31;40901;Edlbach;2017;601;39;7;0;23;670
AT31;40902;Grünburg;2017;3429;137;84;127;63;3840
AT31;40903;Hinterstoder;2017;799;79;8;0;24;910
AT31;40904;Inzersdorf im Kremstal;2017;1776;75;13;5;11;1880
AT31;40905;Kirchdorf an der Krems;2017;3790;334;179;65;134;4502
AT31;40906;Klaus an der Pyhrnbahn;2017;944;92;4;0;23;1063
AT31;40907;Kremsmünster;2017;5534;656;259;18;118;6585
AT31;40908;Micheldorf in Oberösterreich;2017;5305;228;162;83;76;5854
AT31;40909;Molln;2017;3316;95;82;119;41;3653
AT31;40910;Nußbach;2017;2213;66;6;0;1;2286
AT31;40911;Oberschlierbach;2017;467;14;1;1;1;484
AT31;40912;Pettenbach;2017;4842;204;66;100;60;5272
AT31;40913;Ried im Traunkreis;2017;2561;120;16;13;29;2739
AT31;40914;Rosenau am Hengstpaß;2017;589;39;21;0;14;663
AT31;40915;Roßleithen;2017;1793;60;25;0;11;1889
AT31;40916;St. Pankraz;2017;328;22;5;0;7;362
AT31;40917;Schlierbach;2017;2634;107;29;3;85;2858
AT31;40918;Spital am Pyhrn;2017;2067;108;26;1;36;2238
AT31;40919;Steinbach am Ziehberg;2017;808;15;3;0;2;828
AT31;40920;Steinbach an der Steyr;2017;1931;48;6;13;11;2009
AT31;40921;Vorderstoder;2017;771;35;2;0;2;810
AT31;40922;Wartberg an der Krems;2017;2727;133;37;34;62;2993
AT31;40923;Windischgarsten;2017;2100;151;100;1;40;2392
AT31;41001;Allhaming;2017;1116;35;2;11;10;1174
AT31;41002;Ansfelden;2017;12598;1511;912;488;685;16194
AT31;41003;Asten;2017;5624;507;197;136;149;6613
AT31;41004;Eggendorf im Traunkreis;2017;895;41;0;5;3;944
AT31;41005;Enns;2017;9414;1209;875;207;232;11937
AT31;41006;Hargelsberg;2017;1308;45;2;0;16;1371
AT31;41007;Hörsching;2017;5321;502;104;75;60;6062
AT31;41008;Hofkirchen im Traunkreis;2017;1760;117;2;1;19;1899
AT31;41009;Kematen an der Krems;2017;2529;153;44;24;40;2790
AT31;41010;Kirchberg-Thening;2017;2250;66;16;2;30;2364
AT31;41011;Kronstorf;2017;3072;194;93;11;19;3389
AT31;41012;Leonding;2017;24696;2096;739;283;884;28698
AT31;41013;St. Florian;2017;5851;226;27;6;66;6176
AT31;41014;Neuhofen an der Krems;2017;5662;318;161;25;103;6269
AT31;41015;Niederneukirchen;2017;1989;58;12;0;14;2073
AT31;41016;Oftering;2017;1988;51;26;6;5;2076
AT31;41017;Pasching;2017;6412;564;230;140;206;7552
AT31;41018;Piberbach;2017;1814;67;9;1;11;1902
AT31;41019;Pucking;2017;3699;127;47;18;13;3904
AT31;41020;St. Marien;2017;4511;158;35;22;43;4769
AT31;41021;Traun;2017;18716;2468;1845;641;807;24477
AT31;41022;Wilhering;2017;5500;225;58;11;117;5911
AT31;41101;Allerheiligen im Mühlkreis;2017;1230;13;3;0;15;1261
AT31;41102;Arbing;2017;1365;48;11;9;13;1446
AT31;41103;Baumgartenberg;2017;1619;51;3;8;53;1734
AT31;41104;Dimbach;2017;991;6;0;0;16;1013
AT31;41105;Grein;2017;2688;149;18;2;69;2926
AT31;41106;Katsdorf;2017;2943;103;3;0;37;3086
AT31;41107;Klam;2017;894;14;0;2;8;918
AT31;41108;Bad Kreuzen;2017;2150;28;14;2;72;2266
AT31;41109;Langenstein;2017;2289;117;17;31;80;2534
AT31;41110;Luftenberg an der Donau;2017;3792;125;47;14;79;4057
AT31;41111;Mauthausen;2017;4256;263;107;219;91;4936
AT31;41112;Mitterkirchen im Machland;2017;1632;44;12;12;18;1718
AT31;41113;Münzbach;2017;1615;155;18;2;24;1814
AT31;41114;Naarn im Machlande;2017;3395;132;45;65;53;3690
AT31;41115;Pabneukirchen;2017;1650;20;10;0;26;1706
AT31;41116;Perg;2017;7254;484;290;256;104;8388
AT31;41117;Rechberg;2017;963;32;0;0;1;996
AT31;41118;Ried in der Riedmark;2017;4058;77;2;6;67;4210
AT31;41119;St. Georgen am Walde;2017;1980;11;0;0;15;2006
AT31;41120;St. Georgen an der Gusen;2017;3820;123;22;64;90;4119
AT31;41121;St. Nikola an der Donau;2017;619;45;10;10;114;798
AT31;41122;St. Thomas am Blasenstein;2017;908;10;5;0;4;927
AT31;41123;Saxen;2017;1674;79;17;17;33;1820
AT31;41124;Schwertberg;2017;4685;342;74;142;122;5365
AT31;41125;Waldhausen im Strudengau;2017;2738;37;11;0;84;2870
AT31;41126;Windhaag bei Perg;2017;1367;85;38;5;13;1508
AT31;41201;Andrichsfurt;2017;735;31;1;2;1;770
AT31;41202;Antiesenhofen;2017;926;102;41;6;16;1091
AT31;41203;Aurolzmünster;2017;2656;158;89;76;21;3000
AT31;41204;Eberschwang;2017;3106;119;70;2;54;3351
AT31;41205;Eitzing;2017;772;22;1;9;1;805
AT31;41206;Geiersberg;2017;507;7;5;0;0;519
AT31;41207;Geinberg;2017;1269;128;16;7;15;1435
AT31;41208;Gurten;2017;1105;50;13;6;13;1187
AT31;41209;Hohenzell;2017;2129;73;37;5;2;2246
AT31;41210;Kirchdorf am Inn;2017;570;55;1;2;8;636
AT31;41211;Kirchheim im Innkreis;2017;693;18;1;0;4;716
AT31;41212;Lambrechten;2017;1237;49;4;2;8;1300
AT31;41213;Lohnsburg am Kobernaußerwald;2017;2146;73;0;0;15;2234
AT31;41214;Mehrnbach;2017;2183;78;49;9;44;2363
AT31;41215;Mettmach;2017;2282;48;0;1;24;2355
AT31;41216;Mörschwang;2017;309;17;0;0;2;328
AT31;41217;Mühlheim am Inn;2017;599;54;0;1;7;661
AT31;41218;Neuhofen im Innkreis;2017;2232;96;41;13;26;2408
AT31;41219;Obernberg am Inn;2017;1242;325;32;5;29;1633
AT31;41220;Ort im Innkreis;2017;1134;91;16;24;10;1275
AT31;41221;Pattigham;2017;899;20;6;0;3;928
AT31;41222;Peterskirchen;2017;682;14;0;4;0;700
AT31;41223;Pramet;2017;982;35;6;1;6;1030
AT31;41224;Reichersberg;2017;1328;141;22;8;12;1511
AT31;41225;Ried im Innkreis;2017;9397;977;510;554;465;11903
AT31;41226;St. Georgen bei Obernberg am Inn;2017;511;39;8;0;11;569
AT31;41227;St. Marienkirchen am Hausruck;2017;865;16;5;0;2;888
AT31;41228;St. Martin im Innkreis;2017;1625;318;80;11;21;2055
AT31;41229;Schildorn;2017;1176;34;0;0;17;1227
AT31;41230;Senftenbach;2017;707;38;1;9;17;772
AT31;41231;Taiskirchen im Innkreis;2017;2335;60;3;2;7;2407
AT31;41232;Tumeltsham;2017;1482;44;45;13;6;1590
AT31;41233;Utzenaich;2017;1427;77;19;4;9;1536
AT31;41234;Waldzell;2017;2093;59;0;4;21;2177
AT31;41235;Weilbach;2017;574;29;0;0;1;604
AT31;41236;Wippenham;2017;543;15;1;3;16;578
AT31;41304;Altenfelden;2017;2142;18;1;12;46;2219
AT31;41305;Arnreit;2017;1134;4;10;0;6;1154
AT31;41306;Atzesberg;2017;440;5;0;0;1;446
AT31;41307;Auberg;2017;537;12;0;0;2;551
AT31;41309;Haslach an der Mühl;2017;2396;60;17;18;45;2536
AT31;41311;Hörbich;2017;403;4;1;0;12;420
AT31;41312;Hofkirchen im Mühlkreis;2017;1440;48;0;2;30;1520
AT31;41313;Julbach;2017;1486;47;0;0;4;1537
AT31;41314;Kirchberg ob der Donau;2017;1029;22;0;0;4;1055
AT31;41315;Klaffer am Hochficht;2017;1224;41;1;0;45;1311
AT31;41316;Kleinzell im Mühlkreis;2017;1519;15;0;6;6;1546
AT31;41317;Kollerschlag;2017;1462;53;0;2;3;1520
AT31;41318;Lembach im Mühlkreis;2017;1439;28;28;2;33;1530
AT31;41319;Lichtenau im Mühlkreis;2017;471;11;1;0;15;498
AT31;41320;Nebelberg;2017;615;16;0;0;1;632
AT31;41321;Neufelden;2017;1098;34;49;2;93;1276
AT31;41322;Niederkappel;2017;963;11;0;0;11;985
AT31;41323;Niederwaldkirchen;2017;1765;34;0;6;11;1816
AT31;41324;Oberkappel;2017;625;47;0;4;49;725
AT31;41325;Oepping;2017;1489;15;4;2;0;1510
AT31;41326;Peilstein im Mühlviertel;2017;1513;22;0;0;6;1541
AT31;41327;Pfarrkirchen im Mühlkreis;2017;1379;55;0;0;40;1474
AT31;41328;Putzleinsdorf;2017;1469;37;18;0;29;1553
AT31;41329;Neustift im Mühlkreis;2017;1373;54;0;0;34;1461
AT31;41331;St. Johann am Wimberg;2017;1000;18;1;2;8;1029
AT31;41332;St. Martin im Mühlkreis;2017;3602;54;3;36;62;3757
AT31;41333;St. Oswald bei Haslach;2017;486;15;0;0;0;501
AT31;41334;St. Peter am Wimberg;2017;1730;24;0;1;15;1770
AT31;41336;St. Ulrich im Mühlkreis;2017;628;3;0;0;2;633
AT31;41337;St. Veit im Mühlkreis;2017;1176;23;3;0;4;1206
AT31;41338;Sarleinsbach;2017;2221;30;4;1;28;2284
AT31;41341;Schwarzenberg am Böhmerwald;2017;495;63;1;0;7;566
AT31;41342;Ulrichsberg;2017;2703;98;0;5;37;2843
AT31;41343;Aigen-Schlägl;2017;3024;97;25;0;66;3212
AT31;41344;Rohrbach-Berg;2017;4759;167;58;16;134;5134
AT31;41345;Helfenberg;2017;1504;31;5;6;50;1596
AT31;41346;St. Stefan-Afiesl;2017;1075;21;0;0;16;1112
AT31;41401;Altschwendt;2017;663;13;0;2;22;700
AT31;41402;Andorf;2017;4797;157;62;86;72;5174
AT31;41403;Brunnenthal;2017;1830;156;11;15;20;2032
AT31;41404;Diersbach;2017;1499;55;0;0;29;1583
AT31;41405;Dorf an der Pram;2017;1005;17;4;0;13;1039
AT31;41406;Eggerding;2017;1275;41;0;0;4;1320
AT31;41407;Engelhartszell;2017;850;67;4;0;21;942
AT31;41408;Enzenkirchen;2017;1691;56;1;0;24;1772
AT31;41409;Esternberg;2017;2695;150;1;1;8;2855
AT31;41410;Freinberg;2017;1100;352;1;0;5;1458
AT31;41411;Kopfing im Innkreis;2017;1907;46;0;0;55;2008
AT31;41412;Mayrhof;2017;310;10;0;0;2;322
AT31;41413;Münzkirchen;2017;2463;68;4;0;37;2572
AT31;41414;Raab;2017;2114;91;2;26;37;2270
AT31;41415;Rainbach im Innkreis;2017;1429;27;0;9;13;1478
AT31;41416;Riedau;2017;1887;85;21;50;26;2069
AT31;41417;St. Aegidi;2017;1515;32;0;0;9;1556
AT31;41418;St. Florian am Inn;2017;2781;210;10;69;80;3150
AT31;41419;St. Marienkirchen bei Schärding;2017;1707;88;1;28;8;1832
AT31;41420;St. Roman;2017;1676;29;0;0;6;1711
AT31;41421;St. Willibald;2017;1066;33;0;0;1;1100
AT31;41422;Schärding;2017;4166;496;142;176;273;5253
AT31;41423;Schardenberg;2017;2061;316;8;1;21;2407
AT31;41424;Sigharting;2017;793;25;1;3;26;848
AT31;41425;Suben;2017;1183;132;56;33;104;1508
AT31;41426;Taufkirchen an der Pram;2017;2703;102;6;62;52;2925
AT31;41427;Vichtenstein;2017;526;75;0;0;10;611
AT31;41428;Waldkirchen am Wesen;2017;1129;29;0;0;13;1171
AT31;41429;Wernstein am Inn;2017;1383;131;2;2;48;1566
AT31;41430;Zell an der Pram;2017;1860;92;11;35;23;2021
AT31;41501;Adlwang;2017;1736;50;4;5;11;1806
AT31;41502;Aschach an der Steyr;2017;2223;19;11;0;13;2266
AT31;41503;Bad Hall;2017;4634;361;99;82;120;5296
AT31;41504;Dietach;2017;2960;136;71;7;38;3212
AT31;41505;Gaflenz;2017;1872;44;6;0;32;1954
AT31;41506;Garsten;2017;6303;168;62;23;155;6711
AT31;41507;Großraming;2017;2612;37;2;0;51;2702
AT31;41508;Laussa;2017;1215;10;0;0;2;1227
AT31;41509;Losenstein;2017;1509;70;8;0;17;1604
AT31;41510;Maria Neustift;2017;1574;10;0;0;8;1592
AT31;41511;Pfarrkirchen bei Bad Hall;2017;2130;67;8;2;37;2244
AT31;41512;Reichraming;2017;1684;37;5;0;16;1742
AT31;41513;Rohr im Kremstal;2017;1276;55;25;3;15;1374
AT31;41514;St. Ulrich bei Steyr;2017;2886;49;9;1;24;2969
AT31;41515;Schiedlberg;2017;1153;47;1;1;22;1224
AT31;41516;Sierning;2017;8500;412;206;96;157;9371
AT31;41517;Ternberg;2017;3243;71;4;2;47;3367
AT31;41518;Waldneukirchen;2017;2126;50;19;16;31;2242
AT31;41521;Wolfern;2017;3096;60;7;3;7;3173
AT31;41522;Weyer;2017;3952;138;23;7;138;4258
AT31;41601;Alberndorf in der Riedmark;2017;3968;73;6;0;36;4083
AT31;41602;Altenberg bei Linz;2017;4422;92;5;1;33;4553
AT31;41603;Bad Leonfelden;2017;3917;130;24;19;90;4180
AT31;41604;Eidenberg;2017;2023;47;2;0;33;2105
AT31;41605;Engerwitzdorf;2017;8437;191;23;3;136;8790
AT31;41606;Feldkirchen an der Donau;2017;5110;114;69;5;63;5361
AT31;41607;Gallneukirchen;2017;6021;220;62;24;165;6492
AT31;41608;Goldwörth;2017;816;12;0;0;12;840
AT31;41609;Gramastetten;2017;4894;134;7;11;56;5102
AT31;41610;Haibach im Mühlkreis;2017;876;26;0;0;2;904
AT31;41611;Hellmonsödt;2017;2140;88;7;11;57;2303
AT31;41612;Herzogsdorf;2017;2469;29;0;1;7;2506
AT31;41613;Kirchschlag bei Linz;2017;2006;94;3;0;35;2138
AT31;41614;Lichtenberg;2017;2549;40;0;2;46;2637
AT31;41615;Oberneukirchen;2017;3090;56;10;2;44;3202
AT31;41616;Ottenschlag im Mühlkreis;2017;523;13;0;0;3;539
AT31;41617;Ottensheim;2017;4355;190;37;11;128;4721
AT31;41618;Puchenau;2017;4171;155;14;3;102;4445
AT31;41619;Reichenau im Mühlkreis;2017;1243;54;0;0;32;1329
AT31;41620;Reichenthal;2017;1470;27;4;1;11;1513
AT31;41621;St. Gotthard im Mühlkreis;2017;1265;44;0;0;23;1332
AT31;41622;Schenkenfelden;2017;1525;12;4;0;28;1569
AT31;41623;Sonnberg im Mühlkreis;2017;953;10;0;0;3;966
AT31;41624;Steyregg;2017;4528;214;53;2;92;4889
AT31;41626;Walding;2017;3914;87;15;11;68;4095
AT31;41627;Zwettl an der Rodl;2017;1659;26;0;8;59;1752
AT31;41628;Vorderweißenbach;2017;2589;42;3;5;14;2653
AT31;41701;Ampflwang im Hausruckwald;2017;2971;266;46;21;72;3376
AT31;41702;Attersee am Attersee;2017;1460;87;2;0;36;1585
AT31;41703;Attnang-Puchheim;2017;6619;960;706;314;345;8944
AT31;41704;Atzbach;2017;1128;60;0;0;8;1196
AT31;41705;Aurach am Hongar;2017;1644;48;6;2;15;1715
AT31;41706;Berg im Attergau;2017;999;40;1;0;4;1044
AT31;41707;Desselbrunn;2017;1778;57;11;0;11;1857
AT31;41708;Fornach;2017;938;35;0;0;3;976
AT31;41709;Frankenburg am Hausruck;2017;4588;176;57;6;15;4842
AT31;41710;Frankenmarkt;2017;3188;281;73;46;48;3636
AT31;41711;Gampern;2017;2821;65;16;0;25;2927
AT31;41712;Innerschwand am Mondsee;2017;1084;58;4;1;36;1183
AT31;41713;Lenzing;2017;4461;302;154;32;94;5043
AT31;41714;Manning;2017;784;9;1;0;1;795
AT31;41715;Mondsee;2017;2917;501;171;11;134;3734
AT31;41716;Neukirchen an der Vöckla;2017;2472;72;7;0;8;2559
AT31;41717;Niederthalheim;2017;1057;39;1;12;16;1125
AT31;41718;Nußdorf am Attersee;2017;1016;82;15;0;15;1128
AT31;41719;Oberhofen am Irrsee;2017;1520;104;9;1;12;1646
AT31;41720;Oberndorf bei Schwanenstadt;2017;1307;42;35;2;30;1416
AT31;41721;Oberwang;2017;1634;62;4;0;8;1708
AT31;41722;Ottnang am Hausruck;2017;3681;245;12;3;49;3990
AT31;41723;Pfaffing;2017;1412;34;1;1;34;1482
AT31;41724;Pilsbach;2017;614;11;0;1;3;629
AT31;41725;Pitzenberg;2017;516;5;0;1;2;524
AT31;41726;Pöndorf;2017;2237;115;13;14;7;2386
AT31;41727;Puchkirchen am Trattberg;2017;992;35;5;0;4;1036
AT31;41728;Pühret;2017;605;7;1;0;0;613
AT31;41729;Redleiten;2017;500;24;0;2;11;537
AT31;41730;Redlham;2017;1429;50;27;2;7;1515
AT31;41731;Regau;2017;6096;381;162;11;130;6780
AT31;41732;Rüstorf;2017;1956;63;59;7;19;2104
AT31;41733;Rutzenham;2017;281;9;4;0;4;298
AT31;41734;St. Georgen im Attergau;2017;3783;302;160;26;104;4375
AT31;41735;St. Lorenz;2017;2270;171;14;12;26;2493
AT31;41736;Schlatt;2017;1296;62;15;10;16;1399
AT31;41737;Schörfling am Attersee;2017;3185;187;33;0;33;3438
AT31;41738;Schwanenstadt;2017;3398;366;287;81;132;4264
AT31;41739;Seewalchen am Attersee;2017;5120;263;54;3;51;5491
AT31;41740;Steinbach am Attersee;2017;768;87;1;0;10;866
AT31;41741;Straß im Attergau;2017;1353;63;14;4;37;1471
AT31;41742;Tiefgraben;2017;3581;295;27;3;68;3974
AT31;41743;Timelkam;2017;5074;249;189;22;174;5708
AT31;41744;Ungenach;2017;1429;41;0;1;21;1492
AT31;41745;Unterach am Attersee;2017;1263;129;35;1;20;1448
AT31;41746;Vöcklabruck;2017;10074;835;595;97;698;12299
AT31;41747;Vöcklamarkt;2017;4393;259;147;53;72;4924
AT31;41748;Weißenkirchen im Attergau;2017;929;35;0;0;0;964
AT31;41749;Weyregg am Attersee;2017;1517;54;4;0;13;1588
AT31;41750;Wolfsegg am Hausruck;2017;1780;168;3;7;24;1982
AT31;41751;Zell am Moos;2017;1430;78;13;11;43;1575
AT31;41752;Zell am Pettenfirst;2017;1180;36;4;1;15;1236
AT31;41801;Aichkirchen;2017;560;14;2;4;2;582
AT31;41802;Bachmanning;2017;615;69;6;12;2;704
AT31;41803;Bad Wimsbach-Neydharting;2017;2393;74;29;23;14;2533
AT31;41804;Buchkirchen;2017;3873;112;22;15;16;4038
AT31;41805;Eberstalzell;2017;2474;76;48;3;26;2627
AT31;41806;Edt bei Lambach;2017;2016;92;59;12;18;2197
AT31;41807;Fischlham;2017;1286;35;1;2;4;1328
AT31;41808;Gunskirchen;2017;5496;421;90;10;20;6037
AT31;41809;Holzhausen;2017;933;50;6;2;4;995
AT31;41810;Krenglbach;2017;2995;108;29;8;18;3158
AT31;41811;Lambach;2017;2716;333;251;32;103;3435
AT31;41812;Marchtrenk;2017;11439;1291;379;245;249;13603
AT31;41813;Neukirchen bei Lambach;2017;874;30;4;3;6;917
AT31;41814;Offenhausen;2017;1501;101;11;20;5;1638
AT31;41815;Pennewang;2017;859;29;0;0;0;888
AT31;41816;Pichl bei Wels;2017;2641;126;19;58;19;2863
AT31;41817;Sattledt;2017;2324;163;60;78;43;2668
AT31;41818;Schleißheim;2017;1289;75;4;8;13;1389
AT31;41819;Sipbachzell;2017;1883;62;8;7;15;1975
AT31;41820;Stadl-Paura;2017;4146;399;328;58;122;5053
AT31;41821;Steinerkirchen an der Traun;2017;2272;69;13;0;17;2371
AT31;41822;Steinhaus;2017;2078;76;14;1;18;2187
AT31;41823;Thalheim bei Wels;2017;4874;387;113;36;72;5482
AT31;41824;Weißkirchen an der Traun;2017;3174;170;19;20;47;3430
AT31;40101;Linz;2016;159045;17145;11269;3471;12082;203012
AT31;40201;Steyr;2016;31496;2317;2364;924;1223;38324
AT31;40301;Wels;2016;46093;5615;5252;1592;2187;60739
AT31;40401;Altheim;2016;4310;366;155;16;36;4883
AT31;40402;Aspach;2016;2354;145;11;0;11;2521
AT31;40403;Auerbach;2016;511;25;5;0;5;546
AT31;40404;Braunau am Inn;2016;13192;1696;1094;150;755;16887
AT31;40405;Burgkirchen;2016;2424;132;59;1;32;2648
AT31;40406;Eggelsberg;2016;2173;151;29;2;21;2376
AT31;40407;Feldkirchen bei Mattighofen;2016;1836;78;10;0;10;1934
AT31;40408;Franking;2016;828;72;8;1;2;911
AT31;40409;Geretsberg;2016;1019;79;2;0;45;1145
AT31;40410;Gilgenberg am Weilhart;2016;1214;103;5;0;11;1333
AT31;40411;Haigermoos;2016;573;28;0;0;1;602
AT31;40412;Handenberg;2016;1216;65;12;0;4;1297
AT31;40413;Helpfau-Uttendorf;2016;2821;395;250;14;46;3526
AT31;40414;Hochburg-Ach;2016;2472;671;11;1;76;3231
AT31;40415;Höhnhart;2016;1340;46;0;0;6;1392
AT31;40416;Jeging;2016;616;51;11;20;1;699
AT31;40417;Kirchberg bei Mattighofen;2016;1089;51;1;14;5;1160
AT31;40418;Lengau;2016;4261;247;115;60;47;4730
AT31;40419;Lochen am See;2016;2626;93;6;7;8;2740
AT31;40420;Maria Schmolln;2016;1365;40;1;1;26;1433
AT31;40421;Mattighofen;2016;4371;668;946;114;139;6238
AT31;40422;Mauerkirchen;2016;1916;321;228;0;74;2539
AT31;40423;Mining;2016;1102;62;4;0;5;1173
AT31;40424;Moosbach;2016;919;83;2;0;5;1009
AT31;40425;Moosdorf;2016;1493;119;9;0;15;1636
AT31;40426;Munderfing;2016;2664;178;98;24;65;3029
AT31;40427;Neukirchen an der Enknach;2016;2013;71;30;2;30;2146
AT31;40428;Ostermiething;2016;2832;305;81;10;70;3298
AT31;40429;Palting;2016;890;24;3;0;3;920
AT31;40430;Perwang am Grabensee;2016;932;63;0;0;3;998
AT31;40431;Pfaffstätt;2016;913;106;37;0;25;1081
AT31;40432;Pischelsdorf am Engelbach;2016;1521;122;2;2;21;1668
AT31;40433;Polling im Innkreis;2016;906;45;6;0;10;967
AT31;40434;Roßbach;2016;901;33;0;0;3;937
AT31;40435;St. Georgen am Fillmannsbach;2016;375;9;0;0;1;385
AT31;40436;St. Johann am Walde;2016;1955;74;3;1;9;2042
AT31;40437;St. Pantaleon;2016;2687;230;113;8;33;3071
AT31;40438;St. Peter am Hart;2016;2151;208;13;11;78;2461
AT31;40439;St. Radegund;2016;541;44;2;0;0;587
AT31;40440;St. Veit im Innkreis;2016;389;23;1;0;1;414
AT31;40441;Schalchen;2016;3326;229;235;14;20;3824
AT31;40442;Schwand im Innkreis;2016;898;37;6;0;8;949
AT31;40443;Tarsdorf;2016;1895;156;8;1;7;2067
AT31;40444;Treubach;2016;666;38;4;0;6;714
AT31;40445;Überackern;2016;512;187;0;0;3;702
AT31;40446;Weng im Innkreis;2016;1290;51;17;0;19;1377
AT31;40501;Alkoven;2016;5375;195;100;31;108;5809
AT31;40502;Aschach an der Donau;2016;1877;87;172;3;56;2195
AT31;40503;Eferding;2016;3342;180;400;19;94;4035
AT31;40504;Fraham;2016;2185;51;64;0;29;2329
AT31;40505;Haibach ob der Donau;2016;1260;18;1;0;11;1290
AT31;40506;Hartkirchen;2016;3962;54;65;4;39;4124
AT31;40507;Hinzenbach;2016;1867;27;67;8;26;1995
AT31;40508;Prambachkirchen;2016;2721;84;37;9;38;2889
AT31;40509;Pupping;2016;1734;34;21;1;46;1836
AT31;40510;St. Marienkirchen an der Polsenz;2016;2225;41;19;19;28;2332
AT31;40511;Scharten;2016;2155;49;46;7;50;2307
AT31;40512;Stroheim;2016;1518;15;0;0;3;1536
AT31;40601;Freistadt;2016;7112;184;49;243;187;7775
AT31;40602;Grünbach;2016;1873;26;0;1;26;1926
AT31;40603;Gutau;2016;2651;36;0;0;55;2742
AT31;40604;Hagenberg im Mühlkreis;2016;2611;60;2;2;41;2716
AT31;40605;Hirschbach im Mühlkreis;2016;1146;16;1;0;12;1175
AT31;40606;Kaltenberg;2016;617;6;0;0;0;623
AT31;40607;Kefermarkt;2016;2009;48;7;0;33;2097
AT31;40608;Königswiesen;2016;3102;17;1;0;45;3165
AT31;40609;Lasberg;2016;2663;39;3;10;18;2733
AT31;40610;Leopoldschlag;2016;970;13;0;13;20;1016
AT31;40611;Liebenau;2016;1593;7;1;0;1;1602
AT31;40612;Neumarkt im Mühlkreis;2016;3095;55;2;2;20;3174
AT31;40613;Pierbach;2016;983;9;0;0;12;1004
AT31;40614;Pregarten;2016;5003;109;36;9;50;5207
AT31;40615;Rainbach im Mühlkreis;2016;2817;57;0;17;36;2927
AT31;40616;Sandl;2016;1370;19;0;0;13;1402
AT31;40617;St. Leonhard bei Freistadt;2016;1354;11;0;0;6;1371
AT31;40618;St. Oswald bei Freistadt;2016;2778;38;8;3;55;2882
AT31;40619;Schönau im Mühlkreis;2016;1905;10;0;0;3;1918
AT31;40620;Tragwein;2016;2987;56;6;1;33;3083
AT31;40621;Unterweißenbach;2016;2193;18;0;5;3;2219
AT31;40622;Unterweitersdorf;2016;2038;28;4;1;22;2093
AT31;40623;Waldburg;2016;1339;21;0;6;2;1368
AT31;40624;Wartberg ob der Aist;2016;4116;70;4;1;47;4238
AT31;40625;Weitersfelden;2016;1014;33;0;0;3;1050
AT31;40626;Windhaag bei Freistadt;2016;1534;11;2;29;14;1590
AT31;40627;Bad Zell;2016;2801;32;14;7;68;2922
AT31;40701;Altmünster;2016;9105;469;86;13;121;9794
AT31;40702;Bad Goisern am Hallstättersee;2016;7019;370;20;7;98;7514
AT31;40703;Bad Ischl;2016;12279;1021;171;196;328;13995
AT31;40704;Ebensee am Traunsee;2016;7182;320;101;8;99;7710
AT31;40705;Gmunden;2016;11114;1104;619;82;353;13272
AT31;40706;Gosau;2016;1642;89;9;0;40;1780
AT31;40707;Grünau im Almtal;2016;1912;98;12;17;51;2090
AT31;40708;Gschwandt;2016;2628;62;27;1;16;2734
AT31;40709;Hallstatt;2016;668;88;8;0;10;774
AT31;40710;Kirchham;2016;2000;43;2;22;6;2073
AT31;40711;Laakirchen;2016;8484;433;703;48;113;9781
AT31;40712;Obertraun;2016;624;70;1;0;27;722
AT31;40713;Ohlsdorf;2016;4852;183;86;13;67;5201
AT31;40714;Pinsdorf;2016;3416;224;131;13;24;3808
AT31;40715;Roitham am Traunfall;2016;1899;75;11;4;13;2002
AT31;40716;St. Konrad;2016;1056;44;1;0;2;1103
AT31;40717;St. Wolfgang im Salzkammergut;2016;2554;148;53;2;44;2801
AT31;40718;Traunkirchen;2016;1522;81;18;7;9;1637
AT31;40719;Scharnstein;2016;4473;218;61;27;62;4841
AT31;40720;Vorchdorf;2016;6856;217;173;141;84;7471
AT31;40801;Aistersheim;2016;824;39;6;0;19;888
AT31;40802;Bad Schallerbach;2016;3490;332;171;20;68;4081
AT31;40804;Eschenau im Hausruckkreis;2016;1018;13;0;0;2;1033
AT31;40805;Gallspach;2016;2141;264;175;60;122;2762
AT31;40806;Gaspoltshofen;2016;3290;157;41;18;39;3545
AT31;40807;Geboltskirchen;2016;1362;32;5;0;22;1421
AT31;40808;Grieskirchen;2016;4127;323;142;293;127;5012
AT31;40809;Haag am Hausruck;2016;1965;106;69;5;47;2192
AT31;40810;Heiligenberg;2016;669;22;0;0;1;692
AT31;40811;Hofkirchen an der Trattnach;2016;1505;85;53;0;24;1667
AT31;40812;Kallham;2016;2423;55;22;13;3;2516
AT31;40813;Kematen am Innbach;2016;1285;66;15;17;8;1391
AT31;40814;Meggenhofen;2016;1466;34;3;4;23;1530
AT31;40815;Michaelnbach;2016;1242;17;0;0;10;1269
AT31;40816;Natternbach;2016;2257;38;0;0;22;2317
AT31;40817;Neukirchen am Walde;2016;1555;33;7;0;7;1602
AT31;40818;Neumarkt im Hausruckkreis;2016;1273;69;22;86;10;1460
AT31;40820;Pötting;2016;536;4;0;0;0;540
AT31;40821;Pollham;2016;959;17;0;0;11;987
AT31;40822;Pram;2016;1648;44;14;2;19;1727
AT31;40823;Rottenbach;2016;1015;43;13;1;3;1075
AT31;40824;St. Agatha;2016;2088;25;0;0;4;2117
AT31;40825;St. Georgen bei Grieskirchen;2016;1269;28;3;7;3;1310
AT31;40826;St. Thomas;2016;528;14;0;0;1;543
AT31;40827;Schlüßlberg;2016;2887;117;45;42;23;3114
AT31;40828;Steegen;2016;1024;9;8;0;1;1042
AT31;40829;Taufkirchen an der Trattnach;2016;1901;39;8;1;6;1955
AT31;40830;Tollet;2016;899;18;0;0;7;924
AT31;40831;Waizenkirchen;2016;3431;134;84;32;45;3726
AT31;40832;Wallern an der Trattnach;2016;2798;126;32;22;20;2998
AT31;40833;Weibern;2016;1563;45;65;0;37;1710
AT31;40834;Wendling;2016;814;9;0;5;2;830
AT31;40835;Peuerbach;2016;4199;124;42;41;80;4486
AT31;40901;Edlbach;2016;594;33;7;0;26;660
AT31;40902;Grünburg;2016;3440;116;84;133;71;3844
AT31;40903;Hinterstoder;2016;809;85;12;0;20;926
AT31;40904;Inzersdorf im Kremstal;2016;1766;76;12;4;14;1872
AT31;40905;Kirchdorf an der Krems;2016;3731;312;177;55;114;4389
AT31;40906;Klaus an der Pyhrnbahn;2016;952;98;2;0;12;1064
AT31;40907;Kremsmünster;2016;5547;611;245;17;144;6564
AT31;40908;Micheldorf in Oberösterreich;2016;5271;214;169;83;82;5819
AT31;40909;Molln;2016;3292;94;84;122;61;3653
AT31;40910;Nußbach;2016;2193;59;7;2;2;2263
AT31;40911;Oberschlierbach;2016;475;12;1;1;3;492
AT31;40912;Pettenbach;2016;4829;168;66;103;60;5226
AT31;40913;Ried im Traunkreis;2016;2542;103;15;13;24;2697
AT31;40914;Rosenau am Hengstpaß;2016;605;33;21;0;21;680
AT31;40915;Roßleithen;2016;1806;59;27;0;8;1900
AT31;40916;St. Pankraz;2016;312;19;5;0;1;337
AT31;40917;Schlierbach;2016;2652;114;30;4;66;2866
AT31;40918;Spital am Pyhrn;2016;2063;97;28;1;41;2230
AT31;40919;Steinbach am Ziehberg;2016;804;10;3;0;2;819
AT31;40920;Steinbach an der Steyr;2016;1974;38;6;14;12;2044
AT31;40921;Vorderstoder;2016;773;41;2;0;1;817
AT31;40922;Wartberg an der Krems;2016;2745;131;45;30;43;2994
AT31;40923;Windischgarsten;2016;2092;147;104;1;40;2384
AT31;41001;Allhaming;2016;1086;36;2;11;11;1146
AT31;41002;Ansfelden;2016;12625;1434;860;493;632;16044
AT31;41003;Asten;2016;5644;446;189;129;144;6552
AT31;41004;Eggendorf im Traunkreis;2016;877;43;0;6;3;929
AT31;41005;Enns;2016;9436;1090;857;204;229;11816
AT31;41006;Hargelsberg;2016;1308;35;0;0;11;1354
AT31;41007;Hörsching;2016;5328;414;98;74;82;5996
AT31;41008;Hofkirchen im Traunkreis;2016;1758;105;1;1;15;1880
AT31;41009;Kematen an der Krems;2016;2534;135;47;20;34;2770
AT31;41010;Kirchberg-Thening;2016;2230;65;17;2;47;2361
AT31;41011;Kronstorf;2016;3066;177;98;11;40;3392
AT31;41012;Leonding;2016;24395;1895;694;290;807;28081
AT31;41013;St. Florian;2016;5827;192;30;6;69;6124
AT31;41014;Neuhofen an der Krems;2016;5600;286;153;26;104;6169
AT31;41015;Niederneukirchen;2016;1962;45;16;0;14;2037
AT31;41016;Oftering;2016;1970;51;31;6;24;2082
AT31;41017;Pasching;2016;6383;536;208;135;192;7454
AT31;41018;Piberbach;2016;1789;60;8;1;6;1864
AT31;41019;Pucking;2016;3721;120;53;19;12;3925
AT31;41020;St. Marien;2016;4458;132;36;30;45;4701
AT31;41021;Traun;2016;18842;2255;1798;627;773;24295
AT31;41022;Wilhering;2016;5530;228;58;11;121;5948
AT31;41101;Allerheiligen im Mühlkreis;2016;1224;11;2;0;10;1247
AT31;41102;Arbing;2016;1366;36;8;9;12;1431
AT31;41103;Baumgartenberg;2016;1614;46;1;8;49;1718
AT31;41104;Dimbach;2016;992;5;0;0;23;1020
AT31;41105;Grein;2016;2734;141;21;2;75;2973
AT31;41106;Katsdorf;2016;2900;92;0;0;34;3026
AT31;41107;Klam;2016;898;12;0;2;11;923
AT31;41108;Bad Kreuzen;2016;2173;26;6;0;81;2286
AT31;41109;Langenstein;2016;2291;110;18;28;72;2519
AT31;41110;Luftenberg an der Donau;2016;3836;138;42;15;77;4108
AT31;41111;Mauthausen;2016;4261;215;107;213;86;4882
AT31;41112;Mitterkirchen im Machland;2016;1621;46;13;13;19;1712
AT31;41113;Münzbach;2016;1584;139;19;4;26;1772
AT31;41114;Naarn im Machlande;2016;3385;124;45;63;57;3674
AT31;41115;Pabneukirchen;2016;1645;25;12;0;28;1710
AT31;41116;Perg;2016;7254;432;277;256;116;8335
AT31;41117;Rechberg;2016;950;27;0;0;1;978
AT31;41118;Ried in der Riedmark;2016;4027;76;3;13;63;4182
AT31;41119;St. Georgen am Walde;2016;2020;8;0;0;23;2051
AT31;41120;St. Georgen an der Gusen;2016;3720;105;20;46;81;3972
AT31;41121;St. Nikola an der Donau;2016;617;41;9;11;145;823
AT31;41122;St. Thomas am Blasenstein;2016;901;7;2;0;3;913
AT31;41123;Saxen;2016;1669;73;16;16;30;1804
AT31;41124;Schwertberg;2016;4694;317;71;138;113;5333
AT31;41125;Waldhausen im Strudengau;2016;2757;39;11;0;98;2905
AT31;41126;Windhaag bei Perg;2016;1370;75;38;5;17;1505
AT31;41201;Andrichsfurt;2016;727;29;1;0;1;758
AT31;41202;Antiesenhofen;2016;937;86;45;8;15;1091
AT31;41203;Aurolzmünster;2016;2681;118;70;75;23;2967
AT31;41204;Eberschwang;2016;3124;108;64;2;47;3345
AT31;41205;Eitzing;2016;775;17;1;7;1;801
AT31;41206;Geiersberg;2016;519;7;3;0;0;529
AT31;41207;Geinberg;2016;1273;119;18;7;16;1433
AT31;41208;Gurten;2016;1099;53;16;10;26;1204
AT31;41209;Hohenzell;2016;2069;68;31;5;13;2186
AT31;41210;Kirchdorf am Inn;2016;570;49;1;2;14;636
AT31;41211;Kirchheim im Innkreis;2016;695;17;1;0;6;719
AT31;41212;Lambrechten;2016;1253;42;4;2;7;1308
AT31;41213;Lohnsburg am Kobernaußerwald;2016;2126;69;0;0;13;2208
AT31;41214;Mehrnbach;2016;2170;91;34;12;58;2365
AT31;41215;Mettmach;2016;2312;43;0;1;22;2378
AT31;41216;Mörschwang;2016;315;15;0;0;4;334
AT31;41217;Mühlheim am Inn;2016;584;52;0;1;5;642
AT31;41218;Neuhofen im Innkreis;2016;2221;88;33;10;24;2376
AT31;41219;Obernberg am Inn;2016;1255;268;35;5;57;1620
AT31;41220;Ort im Innkreis;2016;1126;81;19;21;9;1256
AT31;41221;Pattigham;2016;877;13;2;0;3;895
AT31;41222;Peterskirchen;2016;668;12;0;4;0;684
AT31;41223;Pramet;2016;958;34;8;1;1;1002
AT31;41224;Reichersberg;2016;1331;144;18;9;31;1533
AT31;41225;Ried im Innkreis;2016;9534;849;506;530;356;11775
AT31;41226;St. Georgen bei Obernberg am Inn;2016;511;31;8;0;6;556
AT31;41227;St. Marienkirchen am Hausruck;2016;854;15;6;0;2;877
AT31;41228;St. Martin im Innkreis;2016;1603;310;74;11;26;2024
AT31;41229;Schildorn;2016;1169;34;0;0;21;1224
AT31;41230;Senftenbach;2016;695;37;1;9;22;764
AT31;41231;Taiskirchen im Innkreis;2016;2339;50;2;2;21;2414
AT31;41232;Tumeltsham;2016;1456;35;38;12;6;1547
AT31;41233;Utzenaich;2016;1414;69;20;2;10;1515
AT31;41234;Waldzell;2016;2069;48;0;4;26;2147
AT31;41235;Weilbach;2016;587;27;2;0;7;623
AT31;41236;Wippenham;2016;548;19;1;1;18;587
AT31;41304;Altenfelden;2016;2128;21;1;15;43;2208
AT31;41305;Arnreit;2016;1132;5;8;0;9;1154
AT31;41306;Atzesberg;2016;440;6;0;0;0;446
AT31;41307;Auberg;2016;539;7;0;0;3;549
AT31;41309;Haslach an der Mühl;2016;2393;55;14;20;48;2530
AT31;41311;Hörbich;2016;405;6;1;0;17;429
AT31;41312;Hofkirchen im Mühlkreis;2016;1435;45;3;1;27;1511
AT31;41313;Julbach;2016;1493;38;0;0;6;1537
AT31;41314;Kirchberg ob der Donau;2016;1019;26;0;0;3;1048
AT31;41315;Klaffer am Hochficht;2016;1239;46;1;0;52;1338
AT31;41316;Kleinzell im Mühlkreis;2016;1524;17;0;6;8;1555
AT31;41317;Kollerschlag;2016;1455;52;0;1;3;1511
AT31;41318;Lembach im Mühlkreis;2016;1439;31;28;0;31;1529
AT31;41319;Lichtenau im Mühlkreis;2016;480;11;1;0;18;510
AT31;41320;Nebelberg;2016;621;14;0;0;0;635
AT31;41321;Neufelden;2016;1119;29;48;1;97;1294
AT31;41322;Niederkappel;2016;964;10;0;0;12;986
AT31;41323;Niederwaldkirchen;2016;1751;30;0;6;12;1799
AT31;41324;Oberkappel;2016;644;44;0;0;61;749
AT31;41325;Oepping;2016;1487;16;4;0;0;1507
AT31;41326;Peilstein im Mühlviertel;2016;1519;22;0;0;1;1542
AT31;41327;Pfarrkirchen im Mühlkreis;2016;1381;51;0;0;47;1479
AT31;41328;Putzleinsdorf;2016;1468;38;13;0;68;1587
AT31;41329;Neustift im Mühlkreis;2016;1382;52;0;0;30;1464
AT31;41331;St. Johann am Wimberg;2016;983;16;1;2;8;1010
AT31;41332;St. Martin im Mühlkreis;2016;3619;58;7;38;54;3776
AT31;41333;St. Oswald bei Haslach;2016;484;14;0;0;0;498
AT31;41334;St. Peter am Wimberg;2016;1732;25;0;2;16;1775
AT31;41336;St. Ulrich im Mühlkreis;2016;624;3;0;0;2;629
AT31;41337;St. Veit im Mühlkreis;2016;1191;19;2;0;4;1216
AT31;41338;Sarleinsbach;2016;2227;34;0;1;37;2299
AT31;41341;Schwarzenberg am Böhmerwald;2016;513;60;1;0;8;582
AT31;41342;Ulrichsberg;2016;2694;95;0;0;47;2836
AT31;41343;Aigen-Schlägl;2016;2991;83;25;1;90;3190
AT31;41344;Rohrbach-Berg;2016;4806;163;68;16;122;5175
AT31;41345;Helfenberg;2016;1495;36;5;6;41;1583
AT31;41346;St. Stefan-Afiesl;2016;1066;18;0;0;17;1101
AT31;41401;Altschwendt;2016;658;20;1;2;26;707
AT31;41402;Andorf;2016;4839;139;60;85;101;5224
AT31;41403;Brunnenthal;2016;1847;153;11;14;16;2041
AT31;41404;Diersbach;2016;1498;51;1;0;39;1589
AT31;41405;Dorf an der Pram;2016;985;17;6;2;18;1028
AT31;41406;Eggerding;2016;1268;42;0;0;18;1328
AT31;41407;Engelhartszell;2016;837;68;4;0;39;948
AT31;41408;Enzenkirchen;2016;1709;51;0;0;26;1786
AT31;41409;Esternberg;2016;2713;156;1;1;16;2887
AT31;41410;Freinberg;2016;1113;322;3;0;6;1444
AT31;41411;Kopfing im Innkreis;2016;1879;41;0;0;54;1974
AT31;41412;Mayrhof;2016;312;6;0;0;2;320
AT31;41413;Münzkirchen;2016;2468;66;5;0;60;2599
AT31;41414;Raab;2016;2121;91;3;29;40;2284
AT31;41415;Rainbach im Innkreis;2016;1430;26;1;8;12;1477
AT31;41416;Riedau;2016;1894;75;23;53;23;2068
AT31;41417;St. Aegidi;2016;1531;28;0;0;12;1571
AT31;41418;St. Florian am Inn;2016;2754;163;18;68;71;3074
AT31;41419;St. Marienkirchen bei Schärding;2016;1705;81;0;29;11;1826
AT31;41420;St. Roman;2016;1707;36;0;1;14;1758
AT31;41421;St. Willibald;2016;1071;31;0;0;2;1104
AT31;41422;Schärding;2016;4171;453;126;158;201;5109
AT31;41423;Schardenberg;2016;2043;311;12;0;18;2384
AT31;41424;Sigharting;2016;784;24;1;3;22;834
AT31;41425;Suben;2016;1176;128;56;32;96;1488
AT31;41426;Taufkirchen an der Pram;2016;2721;93;6;63;47;2930
AT31;41427;Vichtenstein;2016;535;67;0;0;25;627
AT31;41428;Waldkirchen am Wesen;2016;1147;28;0;0;20;1195
AT31;41429;Wernstein am Inn;2016;1373;124;2;0;71;1570
AT31;41430;Zell an der Pram;2016;1860;83;9;32;23;2007
AT31;41501;Adlwang;2016;1723;41;3;5;12;1784
AT31;41502;Aschach an der Steyr;2016;2203;23;3;0;20;2249
AT31;41503;Bad Hall;2016;4530;322;100;78;115;5145
AT31;41504;Dietach;2016;2950;129;69;7;45;3200
AT31;41505;Gaflenz;2016;1844;33;6;0;26;1909
AT31;41506;Garsten;2016;6296;161;67;20;137;6681
AT31;41507;Großraming;2016;2598;36;1;0;59;2694
AT31;41508;Laussa;2016;1231;11;0;5;2;1249
AT31;41509;Losenstein;2016;1523;71;7;0;35;1636
AT31;41510;Maria Neustift;2016;1559;9;0;0;14;1582
AT31;41511;Pfarrkirchen bei Bad Hall;2016;2118;55;8;3;31;2215
AT31;41512;Reichraming;2016;1685;34;5;0;17;1741
AT31;41513;Rohr im Kremstal;2016;1254;45;23;2;19;1343
AT31;41514;St. Ulrich bei Steyr;2016;2921;53;9;11;24;3018
AT31;41515;Schiedlberg;2016;1166;45;1;1;25;1238
AT31;41516;Sierning;2016;8537;354;205;90;153;9339
AT31;41517;Ternberg;2016;3266;66;5;2;37;3376
AT31;41518;Waldneukirchen;2016;2140;40;21;15;31;2247
AT31;41521;Wolfern;2016;3093;50;4;3;40;3190
AT31;41522;Weyer;2016;3963;132;25;4;154;4278
AT31;41601;Alberndorf in der Riedmark;2016;3896;63;6;1;68;4034
AT31;41602;Altenberg bei Linz;2016;4383;84;5;0;56;4528
AT31;41603;Bad Leonfelden;2016;3934;132;23;24;98;4211
AT31;41604;Eidenberg;2016;2037;41;3;0;26;2107
AT31;41605;Engerwitzdorf;2016;8395;196;22;5;123;8741
AT31;41606;Feldkirchen an der Donau;2016;5099;108;63;7;60;5337
AT31;41607;Gallneukirchen;2016;6015;198;62;25;150;6450
AT31;41608;Goldwörth;2016;832;10;0;0;8;850
AT31;41609;Gramastetten;2016;4896;129;7;12;64;5108
AT31;41610;Haibach im Mühlkreis;2016;866;27;0;0;2;895
AT31;41611;Hellmonsödt;2016;2114;84;7;9;46;2260
AT31;41612;Herzogsdorf;2016;2472;31;0;1;9;2513
AT31;41613;Kirchschlag bei Linz;2016;2027;95;4;0;36;2162
AT31;41614;Lichtenberg;2016;2569;38;0;1;48;2656
AT31;41615;Oberneukirchen;2016;3088;53;8;2;37;3188
AT31;41616;Ottenschlag im Mühlkreis;2016;523;15;0;0;2;540
AT31;41617;Ottensheim;2016;4314;180;43;11;169;4717
AT31;41618;Puchenau;2016;4193;152;14;3;100;4462
AT31;41619;Reichenau im Mühlkreis;2016;1239;45;3;0;35;1322
AT31;41620;Reichenthal;2016;1451;38;4;2;39;1534
AT31;41621;St. Gotthard im Mühlkreis;2016;1253;42;0;0;19;1314
AT31;41622;Schenkenfelden;2016;1523;14;4;0;40;1581
AT31;41623;Sonnberg im Mühlkreis;2016;928;9;0;0;4;941
AT31;41624;Steyregg;2016;4563;213;44;3;120;4943
AT31;41626;Walding;2016;3942;90;14;10;71;4127
AT31;41627;Zwettl an der Rodl;2016;1674;25;0;7;66;1772
AT31;41628;Vorderweißenbach;2016;2585;41;3;5;19;2653
AT31;41701;Ampflwang im Hausruckwald;2016;3033;222;46;20;96;3417
AT31;41702;Attersee am Attersee;2016;1476;92;4;0;27;1599
AT31;41703;Attnang-Puchheim;2016;6720;870;655;309;290;8844
AT31;41704;Atzbach;2016;1113;56;0;0;11;1180
AT31;41705;Aurach am Hongar;2016;1628;42;5;3;24;1702
AT31;41706;Berg im Attergau;2016;997;32;3;0;5;1037
AT31;41707;Desselbrunn;2016;1772;50;10;0;13;1845
AT31;41708;Fornach;2016;950;32;0;0;4;986
AT31;41709;Frankenburg am Hausruck;2016;4584;169;56;6;13;4828
AT31;41710;Frankenmarkt;2016;3229;256;75;39;74;3673
AT31;41711;Gampern;2016;2809;63;14;0;31;2917
AT31;41712;Innerschwand am Mondsee;2016;1076;56;4;1;37;1174
AT31;41713;Lenzing;2016;4467;256;128;25;110;4986
AT31;41714;Manning;2016;805;7;1;0;10;823
AT31;41715;Mondsee;2016;2899;469;179;10;116;3673
AT31;41716;Neukirchen an der Vöckla;2016;2445;78;6;1;5;2535
AT31;41717;Niederthalheim;2016;1040;26;1;12;13;1092
AT31;41718;Nußdorf am Attersee;2016;1028;89;16;0;16;1149
AT31;41719;Oberhofen am Irrsee;2016;1506;112;6;1;7;1632
AT31;41720;Oberndorf bei Schwanenstadt;2016;1333;37;27;3;29;1429
AT31;41721;Oberwang;2016;1609;55;3;1;8;1676
AT31;41722;Ottnang am Hausruck;2016;3642;239;12;3;67;3963
AT31;41723;Pfaffing;2016;1422;37;0;0;51;1510
AT31;41724;Pilsbach;2016;613;6;0;0;6;625
AT31;41725;Pitzenberg;2016;494;6;0;0;2;502
AT31;41726;Pöndorf;2016;2232;116;11;14;4;2377
AT31;41727;Puchkirchen am Trattberg;2016;988;45;7;0;10;1050
AT31;41728;Pühret;2016;608;11;1;0;2;622
AT31;41729;Redleiten;2016;493;12;0;2;11;518
AT31;41730;Redlham;2016;1411;48;28;2;8;1497
AT31;41731;Regau;2016;6087;360;160;11;132;6750
AT31;41732;Rüstorf;2016;1961;50;63;8;28;2110
AT31;41733;Rutzenham;2016;266;9;4;0;4;283
AT31;41734;St. Georgen im Attergau;2016;3748;269;164;26;150;4357
AT31;41735;St. Lorenz;2016;2262;166;14;12;22;2476
AT31;41736;Schlatt;2016;1294;64;20;9;9;1396
AT31;41737;Schörfling am Attersee;2016;3175;183;33;2;32;3425
AT31;41738;Schwanenstadt;2016;3410;337;280;82;123;4232
AT31;41739;Seewalchen am Attersee;2016;5098;259;60;4;85;5506
AT31;41740;Steinbach am Attersee;2016;771;86;2;0;15;874
AT31;41741;Straß im Attergau;2016;1340;79;15;6;37;1477
AT31;41742;Tiefgraben;2016;3565;278;24;3;74;3944
AT31;41743;Timelkam;2016;5135;234;204;19;222;5814
AT31;41744;Ungenach;2016;1419;34;0;1;23;1477
AT31;41745;Unterach am Attersee;2016;1256;135;38;3;16;1448
AT31;41746;Vöcklabruck;2016;10167;804;562;93;676;12302
AT31;41747;Vöcklamarkt;2016;4365;239;151;52;83;4890
AT31;41748;Weißenkirchen im Attergau;2016;921;32;0;0;0;953
AT31;41749;Weyregg am Attersee;2016;1503;51;3;0;9;1566
AT31;41750;Wolfsegg am Hausruck;2016;1794;154;3;6;42;1999
AT31;41751;Zell am Moos;2016;1437;82;16;12;52;1599
AT31;41752;Zell am Pettenfirst;2016;1173;34;3;1;11;1222
AT31;41801;Aichkirchen;2016;555;12;2;4;2;575
AT31;41802;Bachmanning;2016;613;66;6;12;2;699
AT31;41803;Bad Wimsbach-Neydharting;2016;2342;58;28;23;20;2471
AT31;41804;Buchkirchen;2016;3909;110;23;15;14;4071
AT31;41805;Eberstalzell;2016;2416;72;53;3;27;2571
AT31;41806;Edt bei Lambach;2016;1987;86;57;11;14;2155
AT31;41807;Fischlham;2016;1310;26;0;2;3;1341
AT31;41808;Gunskirchen;2016;5485;353;78;9;20;5945
AT31;41809;Holzhausen;2016;886;53;4;1;4;948
AT31;41810;Krenglbach;2016;2959;87;28;8;16;3098
AT31;41811;Lambach;2016;2727;307;246;36;93;3409
AT31;41812;Marchtrenk;2016;11325;1127;345;240;247;13284
AT31;41813;Neukirchen bei Lambach;2016;863;28;5;3;5;904
AT31;41814;Offenhausen;2016;1494;83;11;20;5;1613
AT31;41815;Pennewang;2016;863;26;0;0;0;889
AT31;41816;Pichl bei Wels;2016;2581;120;21;58;27;2807
AT31;41817;Sattledt;2016;2305;143;57;71;54;2630
AT31;41818;Schleißheim;2016;1248;65;4;6;11;1334
AT31;41819;Sipbachzell;2016;1868;62;12;7;14;1963
AT31;41820;Stadl-Paura;2016;4124;363;326;62;128;5003
AT31;41821;Steinerkirchen an der Traun;2016;2294;70;18;1;26;2409
AT31;41822;Steinhaus;2016;2012;68;27;1;15;2123
AT31;41823;Thalheim bei Wels;2016;4921;367;120;38;70;5516
AT31;41824;Weißkirchen an der Traun;2016;3129;151;21;20;51;3372
AT31;40101;Linz;2015;159762;15852;10889;3391;10945;200839
AT31;40201;Steyr;2015;31853;2193;2361;904;1036;38347
AT31;40301;Wels;2015;46405;5195;5136;1585;2078;60399
AT31;40401;Altheim;2015;4264;343;159;16;16;4798
AT31;40402;Aspach;2015;2335;149;12;0;5;2501
AT31;40403;Auerbach;2015;505;34;11;0;8;558
AT31;40404;Braunau am Inn;2015;13288;1536;1040;149;704;16717
AT31;40405;Burgkirchen;2015;2415;122;57;1;13;2608
AT31;40406;Eggelsberg;2015;2150;131;25;2;13;2321
AT31;40407;Feldkirchen bei Mattighofen;2015;1845;68;7;0;9;1929
AT31;40408;Franking;2015;846;91;19;0;4;960
AT31;40409;Geretsberg;2015;1012;65;2;0;47;1126
AT31;40410;Gilgenberg am Weilhart;2015;1200;105;6;0;14;1325
AT31;40411;Haigermoos;2015;571;24;0;0;1;596
AT31;40412;Handenberg;2015;1215;58;13;0;2;1288
AT31;40413;Helpfau-Uttendorf;2015;2802;357;230;15;38;3442
AT31;40414;Hochburg-Ach;2015;2481;640;12;1;37;3171
AT31;40415;Höhnhart;2015;1357;48;0;0;4;1409
AT31;40416;Jeging;2015;613;46;14;18;2;693
AT31;40417;Kirchberg bei Mattighofen;2015;1079;38;2;13;5;1137
AT31;40418;Lengau;2015;4164;226;108;47;25;4570
AT31;40419;Lochen am See;2015;2562;78;5;5;11;2661
AT31;40420;Maria Schmolln;2015;1369;28;1;1;39;1438
AT31;40421;Mattighofen;2015;4418;599;922;104;106;6149
AT31;40422;Mauerkirchen;2015;1879;272;220;0;92;2463
AT31;40423;Mining;2015;1097;58;7;0;4;1166
AT31;40424;Moosbach;2015;919;46;3;0;5;973
AT31;40425;Moosdorf;2015;1507;108;8;0;9;1632
AT31;40426;Munderfing;2015;2665;163;91;24;20;2963
AT31;40427;Neukirchen an der Enknach;2015;2032;75;28;2;29;2166
AT31;40428;Ostermiething;2015;2838;280;86;10;76;3290
AT31;40429;Palting;2015;880;25;3;0;3;911
AT31;40430;Perwang am Grabensee;2015;918;53;0;0;2;973
AT31;40431;Pfaffstätt;2015;896;83;27;0;10;1016
AT31;40432;Pischelsdorf am Engelbach;2015;1528;109;2;2;24;1665
AT31;40433;Polling im Innkreis;2015;901;34;6;0;5;946
AT31;40434;Roßbach;2015;897;36;0;0;3;936
AT31;40435;St. Georgen am Fillmannsbach;2015;375;8;0;0;1;384
AT31;40436;St. Johann am Walde;2015;1950;84;2;1;9;2046
AT31;40437;St. Pantaleon;2015;2674;240;114;7;28;3063
AT31;40438;St. Peter am Hart;2015;2155;191;20;10;75;2451
AT31;40439;St. Radegund;2015;537;46;2;0;0;585
AT31;40440;St. Veit im Innkreis;2015;393;23;1;0;2;419
AT31;40441;Schalchen;2015;3321;198;231;11;19;3780
AT31;40442;Schwand im Innkreis;2015;881;31;0;0;6;918
AT31;40443;Tarsdorf;2015;1873;154;7;1;5;2040
AT31;40444;Treubach;2015;662;39;3;0;5;709
AT31;40445;Überackern;2015;499;183;0;0;3;685
AT31;40446;Weng im Innkreis;2015;1296;52;14;0;16;1378
AT31;40501;Alkoven;2015;5368;214;93;25;108;5808
AT31;40502;Aschach an der Donau;2015;1906;85;171;4;27;2193
AT31;40503;Eferding;2015;3388;155;397;21;45;4006
AT31;40504;Fraham;2015;2197;55;64;0;8;2324
AT31;40505;Haibach ob der Donau;2015;1264;19;0;0;11;1294
AT31;40506;Hartkirchen;2015;3967;46;68;4;26;4111
AT31;40507;Hinzenbach;2015;1854;26;70;6;26;1982
AT31;40508;Prambachkirchen;2015;2705;86;28;9;40;2868
AT31;40509;Pupping;2015;1736;32;29;1;38;1836
AT31;40510;St. Marienkirchen an der Polsenz;2015;2214;37;21;18;20;2310
AT31;40511;Scharten;2015;2119;43;38;5;62;2267
AT31;40512;Stroheim;2015;1521;14;0;0;4;1539
AT31;40601;Freistadt;2015;7042;171;49;244;197;7703
AT31;40602;Grünbach;2015;1855;28;0;1;3;1887
AT31;40603;Gutau;2015;2634;41;0;0;44;2719
AT31;40604;Hagenberg im Mühlkreis;2015;2645;52;2;0;28;2727
AT31;40605;Hirschbach im Mühlkreis;2015;1134;13;1;0;1;1149
AT31;40606;Kaltenberg;2015;624;6;0;0;0;630
AT31;40607;Kefermarkt;2015;2005;47;7;0;24;2083
AT31;40608;Königswiesen;2015;3140;17;2;0;31;3190
AT31;40609;Lasberg;2015;2697;35;3;11;15;2761
AT31;40610;Leopoldschlag;2015;999;12;0;14;33;1058
AT31;40611;Liebenau;2015;1621;10;1;0;1;1633
AT31;40612;Neumarkt im Mühlkreis;2015;3074;46;2;2;21;3145
AT31;40613;Pierbach;2015;974;11;0;0;15;1000
AT31;40614;Pregarten;2015;5016;112;36;9;60;5233
AT31;40615;Rainbach im Mühlkreis;2015;2822;71;3;18;33;2947
AT31;40616;Sandl;2015;1370;15;1;0;15;1401
AT31;40617;St. Leonhard bei Freistadt;2015;1349;9;0;0;7;1365
AT31;40618;St. Oswald bei Freistadt;2015;2782;36;7;3;45;2873
AT31;40619;Schönau im Mühlkreis;2015;1923;14;0;0;12;1949
AT31;40620;Tragwein;2015;2967;50;8;0;33;3058
AT31;40621;Unterweißenbach;2015;2199;16;0;5;4;2224
AT31;40622;Unterweitersdorf;2015;2015;25;6;3;10;2059
AT31;40623;Waldburg;2015;1326;16;1;6;1;1350
AT31;40624;Wartberg ob der Aist;2015;4087;65;3;2;55;4212
AT31;40625;Weitersfelden;2015;1006;29;1;0;3;1039
AT31;40626;Windhaag bei Freistadt;2015;1528;11;2;32;17;1590
AT31;40627;Bad Zell;2015;2740;28;19;6;75;2868
AT31;40701;Altmünster;2015;9057;438;110;15;165;9785
AT31;40702;Bad Goisern am Hallstättersee;2015;7020;353;20;7;78;7478
AT31;40703;Bad Ischl;2015;12216;967;177;201;340;13901
AT31;40704;Ebensee am Traunsee;2015;7250;301;104;7;76;7738
AT31;40705;Gmunden;2015;11205;1020;616;87;276;13204
AT31;40706;Gosau;2015;1646;80;5;0;43;1774
AT31;40707;Grünau im Almtal;2015;1918;95;12;22;57;2104
AT31;40708;Gschwandt;2015;2601;53;23;1;12;2690
AT31;40709;Hallstatt;2015;671;73;9;0;5;758
AT31;40710;Kirchham;2015;1969;41;1;17;8;2036
AT31;40711;Laakirchen;2015;8544;384;692;61;126;9807
AT31;40712;Obertraun;2015;639;69;1;0;31;740
AT31;40713;Ohlsdorf;2015;4796;167;87;9;113;5172
AT31;40714;Pinsdorf;2015;3451;209;128;10;21;3819
AT31;40715;Roitham am Traunfall;2015;1905;61;12;8;15;2001
AT31;40716;St. Konrad;2015;1068;42;1;0;2;1113
AT31;40717;St. Wolfgang im Salzkammergut;2015;2559;155;60;7;42;2823
AT31;40718;Traunkirchen;2015;1512;82;16;7;7;1624
AT31;40719;Scharnstein;2015;4431;191;70;28;60;4780
AT31;40720;Vorchdorf;2015;6821;204;164;137;72;7398
AT31;40801;Aistersheim;2015;801;50;6;1;17;875
AT31;40802;Bad Schallerbach;2015;3459;302;174;12;58;4005
AT31;40804;Eschenau im Hausruckkreis;2015;1022;11;0;0;4;1037
AT31;40805;Gallspach;2015;2180;284;165;58;178;2865
AT31;40806;Gaspoltshofen;2015;3306;148;43;18;48;3563
AT31;40807;Geboltskirchen;2015;1358;33;5;0;18;1414
AT31;40808;Grieskirchen;2015;4105;292;136;290;79;4902
AT31;40809;Haag am Hausruck;2015;1957;82;63;6;51;2159
AT31;40810;Heiligenberg;2015;654;20;0;0;0;674
AT31;40811;Hofkirchen an der Trattnach;2015;1509;75;54;0;2;1640
AT31;40812;Kallham;2015;2353;55;25;12;4;2449
AT31;40813;Kematen am Innbach;2015;1266;63;12;21;4;1366
AT31;40814;Meggenhofen;2015;1447;35;1;3;6;1492
AT31;40815;Michaelnbach;2015;1245;18;0;0;3;1266
AT31;40816;Natternbach;2015;2276;38;0;1;15;2330
AT31;40817;Neukirchen am Walde;2015;1562;31;7;0;9;1609
AT31;40818;Neumarkt im Hausruckkreis;2015;1253;52;18;80;9;1412
AT31;40820;Pötting;2015;530;3;0;0;0;533
AT31;40821;Pollham;2015;951;15;1;0;7;974
AT31;40822;Pram;2015;1639;48;13;0;6;1706
AT31;40823;Rottenbach;2015;1020;36;13;1;3;1073
AT31;40824;St. Agatha;2015;2104;20;0;0;3;2127
AT31;40825;St. Georgen bei Grieskirchen;2015;1243;32;2;7;1;1285
AT31;40826;St. Thomas;2015;540;14;0;0;2;556
AT31;40827;Schlüßlberg;2015;2895;86;44;31;26;3082
AT31;40828;Steegen;2015;1033;7;7;0;1;1048
AT31;40829;Taufkirchen an der Trattnach;2015;1925;40;6;3;6;1980
AT31;40830;Tollet;2015;877;17;0;0;6;900
AT31;40831;Waizenkirchen;2015;3400;124;76;32;18;3650
AT31;40832;Wallern an der Trattnach;2015;2775;111;28;24;23;2961
AT31;40833;Weibern;2015;1562;38;66;6;36;1708
AT31;40834;Wendling;2015;814;7;1;5;2;829
AT31;40835;Peuerbach;2015;4279;100;41;50;68;4538
AT31;40901;Edlbach;2015;607;33;4;0;1;645
AT31;40902;Grünburg;2015;3447;109;87;129;16;3788
AT31;40903;Hinterstoder;2015;815;82;11;0;15;923
AT31;40904;Inzersdorf im Kremstal;2015;1795;76;13;4;8;1896
AT31;40905;Kirchdorf an der Krems;2015;3715;281;168;61;98;4323
AT31;40906;Klaus an der Pyhrnbahn;2015;970;94;6;0;9;1079
AT31;40907;Kremsmünster;2015;5587;545;257;16;133;6538
AT31;40908;Micheldorf in Oberösterreich;2015;5280;216;156;78;78;5808
AT31;40909;Molln;2015;3280;96;87;109;23;3595
AT31;40910;Nußbach;2015;2165;53;7;2;22;2249
AT31;40911;Oberschlierbach;2015;470;15;1;1;3;490
AT31;40912;Pettenbach;2015;4806;161;68;101;45;5181
AT31;40913;Ried im Traunkreis;2015;2551;84;15;13;32;2695
AT31;40914;Rosenau am Hengstpaß;2015;599;25;22;0;31;677
AT31;40915;Roßleithen;2015;1799;63;30;0;6;1898
AT31;40916;St. Pankraz;2015;324;23;6;0;0;353
AT31;40917;Schlierbach;2015;2672;96;28;5;68;2869
AT31;40918;Spital am Pyhrn;2015;2060;96;29;1;48;2234
AT31;40919;Steinbach am Ziehberg;2015;801;15;4;0;2;822
AT31;40920;Steinbach an der Steyr;2015;1967;36;6;19;10;2038
AT31;40921;Vorderstoder;2015;764;41;2;0;1;808
AT31;40922;Wartberg an der Krems;2015;2734;126;50;30;40;2980
AT31;40923;Windischgarsten;2015;2108;145;113;1;32;2399
AT31;41001;Allhaming;2015;1090;40;1;11;6;1148
AT31;41002;Ansfelden;2015;12764;1310;846;492;631;16043
AT31;41003;Asten;2015;5581;413;171;112;94;6371
AT31;41004;Eggendorf im Traunkreis;2015;849;42;0;6;2;899
AT31;41005;Enns;2015;9508;963;836;221;208;11736
AT31;41006;Hargelsberg;2015;1310;26;2;0;3;1341
AT31;41007;Hörsching;2015;5292;376;101;87;183;6039
AT31;41008;Hofkirchen im Traunkreis;2015;1736;96;2;1;22;1857
AT31;41009;Kematen an der Krems;2015;2457;124;40;21;35;2677
AT31;41010;Kirchberg-Thening;2015;2221;59;17;3;55;2355
AT31;41011;Kronstorf;2015;2962;155;84;11;16;3228
AT31;41012;Leonding;2015;23973;1716;682;265;757;27393
AT31;41013;St. Florian;2015;5807;189;30;5;46;6077
AT31;41014;Neuhofen an der Krems;2015;5532;257;151;22;79;6041
AT31;41015;Niederneukirchen;2015;1944;42;16;0;20;2022
AT31;41016;Oftering;2015;1953;52;30;7;29;2071
AT31;41017;Pasching;2015;6291;473;209;130;171;7274
AT31;41018;Piberbach;2015;1787;66;8;1;8;1870
AT31;41019;Pucking;2015;3672;113;50;20;10;3865
AT31;41020;St. Marien;2015;4409;128;35;37;35;4644
AT31;41021;Traun;2015;18913;2079;1757;643;666;24058
AT31;41022;Wilhering;2015;5575;235;59;12;129;6010
AT31;41101;Allerheiligen im Mühlkreis;2015;1208;8;2;0;16;1234
AT31;41102;Arbing;2015;1362;35;8;9;21;1435
AT31;41103;Baumgartenberg;2015;1582;48;0;8;45;1683
AT31;41104;Dimbach;2015;998;8;0;0;26;1032
AT31;41105;Grein;2015;2770;132;21;2;67;2992
AT31;41106;Katsdorf;2015;2866;80;0;0;32;2978
AT31;41107;Klam;2015;896;14;0;2;0;912
AT31;41108;Bad Kreuzen;2015;2145;23;7;1;153;2329
AT31;41109;Langenstein;2015;2285;101;13;31;83;2513
AT31;41110;Luftenberg an der Donau;2015;3807;131;40;15;83;4076
AT31;41111;Mauthausen;2015;4251;213;114;205;66;4849
AT31;41112;Mitterkirchen im Machland;2015;1633;54;9;12;27;1735
AT31;41113;Münzbach;2015;1595;114;20;5;0;1734
AT31;41114;Naarn im Machlande;2015;3408;124;46;58;55;3691
AT31;41115;Pabneukirchen;2015;1671;20;13;0;15;1719
AT31;41116;Perg;2015;7232;411;267;265;99;8274
AT31;41117;Rechberg;2015;942;20;0;0;1;963
AT31;41118;Ried in der Riedmark;2015;4008;60;4;15;9;4096
AT31;41119;St. Georgen am Walde;2015;2012;8;0;0;27;2047
AT31;41120;St. Georgen an der Gusen;2015;3689;95;22;49;61;3916
AT31;41121;St. Nikola an der Donau;2015;618;40;9;10;139;816
AT31;41122;St. Thomas am Blasenstein;2015;904;6;4;0;3;917
AT31;41123;Saxen;2015;1684;67;15;16;34;1816
AT31;41124;Schwertberg;2015;4726;258;69;140;115;5308
AT31;41125;Waldhausen im Strudengau;2015;2769;37;12;0;85;2903
AT31;41126;Windhaag bei Perg;2015;1368;50;36;6;17;1477
AT31;41201;Andrichsfurt;2015;728;20;0;0;1;749
AT31;41202;Antiesenhofen;2015;938;83;42;9;0;1072
AT31;41203;Aurolzmünster;2015;2642;86;57;70;15;2870
AT31;41204;Eberschwang;2015;3178;115;61;2;31;3387
AT31;41205;Eitzing;2015;746;15;1;6;1;769
AT31;41206;Geiersberg;2015;520;5;3;0;0;528
AT31;41207;Geinberg;2015;1301;94;20;7;30;1452
AT31;41208;Gurten;2015;1077;42;16;16;12;1163
AT31;41209;Hohenzell;2015;2073;52;26;6;20;2177
AT31;41210;Kirchdorf am Inn;2015;568;49;1;2;1;621
AT31;41211;Kirchheim im Innkreis;2015;695;16;1;0;6;718
AT31;41212;Lambrechten;2015;1254;41;4;0;11;1310
AT31;41213;Lohnsburg am Kobernaußerwald;2015;2137;69;0;1;10;2217
AT31;41214;Mehrnbach;2015;2146;85;28;13;48;2320
AT31;41215;Mettmach;2015;2314;44;0;3;17;2378
AT31;41216;Mörschwang;2015;308;16;0;0;3;327
AT31;41217;Mühlheim am Inn;2015;611;47;0;1;10;669
AT31;41218;Neuhofen im Innkreis;2015;2196;94;33;9;26;2358
AT31;41219;Obernberg am Inn;2015;1279;234;33;5;64;1615
AT31;41220;Ort im Innkreis;2015;1109;61;22;21;6;1219
AT31;41221;Pattigham;2015;869;13;2;0;3;887
AT31;41222;Peterskirchen;2015;667;9;0;4;0;680
AT31;41223;Pramet;2015;963;28;9;0;1;1001
AT31;41224;Reichersberg;2015;1328;134;22;11;37;1532
AT31;41225;Ried im Innkreis;2015;9651;732;506;499;284;11672
AT31;41226;St. Georgen bei Obernberg am Inn;2015;512;20;8;0;5;545
AT31;41227;St. Marienkirchen am Hausruck;2015;837;14;5;0;3;859
AT31;41228;St. Martin im Innkreis;2015;1588;281;67;10;31;1977
AT31;41229;Schildorn;2015;1145;26;0;0;23;1194
AT31;41230;Senftenbach;2015;711;35;1;9;23;779
AT31;41231;Taiskirchen im Innkreis;2015;2336;50;1;2;9;2398
AT31;41232;Tumeltsham;2015;1463;29;38;12;6;1548
AT31;41233;Utzenaich;2015;1438;70;17;2;5;1532
AT31;41234;Waldzell;2015;2091;49;1;4;25;2170
AT31;41235;Weilbach;2015;584;25;0;0;1;610
AT31;41236;Wippenham;2015;534;16;4;1;1;556
AT31;41304;Altenfelden;2015;2106;20;1;12;9;2148
AT31;41305;Arnreit;2015;1130;4;9;0;8;1151
AT31;41306;Atzesberg;2015;440;5;0;0;0;445
AT31;41307;Auberg;2015;534;7;0;0;4;545
AT31;41309;Haslach an der Mühl;2015;2399;54;7;21;49;2530
AT31;41311;Hörbich;2015;417;6;1;0;1;425
AT31;41312;Hofkirchen im Mühlkreis;2015;1424;48;5;1;32;1510
AT31;41313;Julbach;2015;1497;39;0;0;2;1538
AT31;41314;Kirchberg ob der Donau;2015;1025;22;0;0;1;1048
AT31;41315;Klaffer am Hochficht;2015;1233;48;6;0;44;1331
AT31;41316;Kleinzell im Mühlkreis;2015;1513;14;0;6;5;1538
AT31;41317;Kollerschlag;2015;1434;45;0;0;5;1484
AT31;41318;Lembach im Mühlkreis;2015;1436;30;26;0;23;1515
AT31;41319;Lichtenau im Mühlkreis;2015;494;12;1;0;1;508
AT31;41320;Nebelberg;2015;634;14;0;0;0;648
AT31;41321;Neufelden;2015;1127;30;48;1;120;1326
AT31;41322;Niederkappel;2015;969;9;0;0;28;1006
AT31;41323;Niederwaldkirchen;2015;1752;19;0;4;17;1792
AT31;41324;Oberkappel;2015;643;42;0;0;61;746
AT31;41325;Oepping;2015;1491;11;5;0;0;1507
AT31;41326;Peilstein im Mühlviertel;2015;1533;19;0;0;1;1553
AT31;41327;Pfarrkirchen im Mühlkreis;2015;1404;53;0;0;31;1488
AT31;41328;Putzleinsdorf;2015;1469;31;14;0;78;1592
AT31;41329;Neustift im Mühlkreis;2015;1367;54;0;0;40;1461
AT31;41331;St. Johann am Wimberg;2015;1009;14;1;2;8;1034
AT31;41332;St. Martin im Mühlkreis;2015;3579;48;6;39;10;3682
AT31;41333;St. Oswald bei Haslach;2015;486;14;0;0;0;500
AT31;41334;St. Peter am Wimberg;2015;1736;20;0;2;19;1777
AT31;41336;St. Ulrich im Mühlkreis;2015;623;7;0;3;4;637
AT31;41337;St. Veit im Mühlkreis;2015;1168;16;2;0;4;1190
AT31;41338;Sarleinsbach;2015;2218;29;1;1;28;2277
AT31;41341;Schwarzenberg am Böhmerwald;2015;538;71;1;0;25;635
AT31;41342;Ulrichsberg;2015;2713;89;3;0;30;2835
AT31;41343;Aigen-Schlägl;2015;2995;72;25;2;49;3143
AT31;41344;Rohrbach-Berg;2015;4802;164;69;20;105;5160
AT31;41345;Helfenberg;2015;1492;31;4;22;39;1588
AT31;41346;St. Stefan-Afiesl;2015;1072;20;0;0;15;1107
AT31;41401;Altschwendt;2015;665;16;1;2;24;708
AT31;41402;Andorf;2015;4835;134;58;81;21;5129
AT31;41403;Brunnenthal;2015;1825;145;12;12;15;2009
AT31;41404;Diersbach;2015;1483;44;0;0;26;1553
AT31;41405;Dorf an der Pram;2015;990;20;2;2;23;1037
AT31;41406;Eggerding;2015;1243;38;0;0;29;1310
AT31;41407;Engelhartszell;2015;859;64;4;0;56;983
AT31;41408;Enzenkirchen;2015;1711;57;0;0;7;1775
AT31;41409;Esternberg;2015;2714;143;1;1;9;2868
AT31;41410;Freinberg;2015;1115;327;10;0;7;1459
AT31;41411;Kopfing im Innkreis;2015;1871;49;0;0;21;1941
AT31;41412;Mayrhof;2015;294;6;0;0;2;302
AT31;41413;Münzkirchen;2015;2471;59;6;0;38;2574
AT31;41414;Raab;2015;2144;93;4;28;29;2298
AT31;41415;Rainbach im Innkreis;2015;1433;30;1;9;13;1486
AT31;41416;Riedau;2015;1865;69;28;59;21;2042
AT31;41417;St. Aegidi;2015;1539;27;0;0;7;1573
AT31;41418;St. Florian am Inn;2015;2787;156;20;72;66;3101
AT31;41419;St. Marienkirchen bei Schärding;2015;1688;67;0;32;7;1794
AT31;41420;St. Roman;2015;1715;40;0;0;0;1755
AT31;41421;St. Willibald;2015;1085;37;0;1;2;1125
AT31;41422;Schärding;2015;4149;410;122;159;157;4997
AT31;41423;Schardenberg;2015;2051;307;6;0;11;2375
AT31;41424;Sigharting;2015;777;20;0;3;28;828
AT31;41425;Suben;2015;1192;155;46;32;79;1504
AT31;41426;Taufkirchen an der Pram;2015;2727;92;8;65;50;2942
AT31;41427;Vichtenstein;2015;534;81;0;0;29;644
AT31;41428;Waldkirchen am Wesen;2015;1147;32;0;0;19;1198
AT31;41429;Wernstein am Inn;2015;1385;121;2;0;75;1583
AT31;41430;Zell an der Pram;2015;1869;80;10;30;24;2013
AT31;41501;Adlwang;2015;1707;52;3;5;12;1779
AT31;41502;Aschach an der Steyr;2015;2179;22;6;0;17;2224
AT31;41503;Bad Hall;2015;4477;288;84;89;107;5045
AT31;41504;Dietach;2015;2894;125;61;8;38;3126
AT31;41505;Gaflenz;2015;1854;38;6;0;26;1924
AT31;41506;Garsten;2015;6272;170;64;20;119;6645
AT31;41507;Großraming;2015;2628;31;2;0;71;2732
AT31;41508;Laussa;2015;1238;10;0;0;2;1250
AT31;41509;Losenstein;2015;1535;49;7;0;36;1627
AT31;41510;Maria Neustift;2015;1562;7;0;0;11;1580
AT31;41511;Pfarrkirchen bei Bad Hall;2015;2097;42;12;1;10;2162
AT31;41512;Reichraming;2015;1682;33;5;0;11;1731
AT31;41513;Rohr im Kremstal;2015;1221;33;23;1;34;1312
AT31;41514;St. Ulrich bei Steyr;2015;2924;47;9;8;22;3010
AT31;41515;Schiedlberg;2015;1152;41;1;1;31;1226
AT31;41516;Sierning;2015;8509;308;207;89;105;9218
AT31;41517;Ternberg;2015;3258;72;5;2;53;3390
AT31;41518;Waldneukirchen;2015;2160;37;18;14;8;2237
AT31;41521;Wolfern;2015;3046;53;5;3;39;3146
AT31;41522;Weyer;2015;3978;113;30;6;137;4264
AT31;41601;Alberndorf in der Riedmark;2015;3877;58;5;1;20;3961
AT31;41602;Altenberg bei Linz;2015;4366;79;4;0;60;4509
AT31;41603;Bad Leonfelden;2015;3918;122;38;18;114;4210
AT31;41604;Eidenberg;2015;1999;39;2;0;25;2065
AT31;41605;Engerwitzdorf;2015;8354;173;22;4;108;8661
AT31;41606;Feldkirchen an der Donau;2015;5081;99;59;6;30;5275
AT31;41607;Gallneukirchen;2015;5954;175;56;18;107;6310
AT31;41608;Goldwörth;2015;874;11;1;0;8;894
AT31;41609;Gramastetten;2015;4840;114;5;8;71;5038
AT31;41610;Haibach im Mühlkreis;2015;858;27;0;0;3;888
AT31;41611;Hellmonsödt;2015;2119;76;9;11;36;2251
AT31;41612;Herzogsdorf;2015;2439;23;0;0;9;2471
AT31;41613;Kirchschlag bei Linz;2015;1971;99;4;0;29;2103
AT31;41614;Lichtenberg;2015;2590;40;0;2;55;2687
AT31;41615;Oberneukirchen;2015;3048;51;12;2;44;3157
AT31;41616;Ottenschlag im Mühlkreis;2015;515;9;0;0;1;525
AT31;41617;Ottensheim;2015;4261;155;35;9;179;4639
AT31;41618;Puchenau;2015;4200;144;16;4;62;4426
AT31;41619;Reichenau im Mühlkreis;2015;1222;32;0;1;25;1280
AT31;41620;Reichenthal;2015;1446;33;2;3;37;1521
AT31;41621;St. Gotthard im Mühlkreis;2015;1239;39;0;0;11;1289
AT31;41622;Schenkenfelden;2015;1522;14;4;0;48;1588
AT31;41623;Sonnberg im Mühlkreis;2015;905;7;0;0;7;919
AT31;41624;Steyregg;2015;4589;201;53;5;222;5070
AT31;41626;Walding;2015;3858;78;13;10;81;4040
AT31;41627;Zwettl an der Rodl;2015;1697;22;0;7;70;1796
AT31;41628;Vorderweißenbach;2015;2558;43;3;5;10;2619
AT31;41701;Ampflwang im Hausruckwald;2015;3029;207;43;20;110;3409
AT31;41702;Attersee am Attersee;2015;1474;90;4;0;36;1604
AT31;41703;Attnang-Puchheim;2015;6784;813;675;292;275;8839
AT31;41704;Atzbach;2015;1122;48;0;0;8;1178
AT31;41705;Aurach am Hongar;2015;1611;46;5;4;6;1672
AT31;41706;Berg im Attergau;2015;990;29;3;0;6;1028
AT31;41707;Desselbrunn;2015;1725;52;18;0;12;1807
AT31;41708;Fornach;2015;927;23;0;0;2;952
AT31;41709;Frankenburg am Hausruck;2015;4595;149;51;10;107;4912
AT31;41710;Frankenmarkt;2015;3261;233;76;40;97;3707
AT31;41711;Gampern;2015;2743;62;14;0;32;2851
AT31;41712;Innerschwand am Mondsee;2015;1052;60;3;1;49;1165
AT31;41713;Lenzing;2015;4482;244;138;27;111;5002
AT31;41714;Manning;2015;810;8;2;0;2;822
AT31;41715;Mondsee;2015;2857;453;187;10;190;3697
AT31;41716;Neukirchen an der Vöckla;2015;2467;62;13;1;5;2548
AT31;41717;Niederthalheim;2015;1034;24;1;12;15;1086
AT31;41718;Nußdorf am Attersee;2015;1044;76;17;0;14;1151
AT31;41719;Oberhofen am Irrsee;2015;1475;100;6;1;7;1589
AT31;41720;Oberndorf bei Schwanenstadt;2015;1356;25;27;4;8;1420
AT31;41721;Oberwang;2015;1600;44;4;1;8;1657
AT31;41722;Ottnang am Hausruck;2015;3603;196;9;3;45;3856
AT31;41723;Pfaffing;2015;1420;33;0;0;51;1504
AT31;41724;Pilsbach;2015;598;6;0;0;4;608
AT31;41725;Pitzenberg;2015;504;5;0;0;2;511
AT31;41726;Pöndorf;2015;2223;92;8;14;2;2339
AT31;41727;Puchkirchen am Trattberg;2015;983;40;9;0;13;1045
AT31;41728;Pühret;2015;598;10;1;0;5;614
AT31;41729;Redleiten;2015;494;15;0;1;5;515
AT31;41730;Redlham;2015;1380;50;32;1;12;1475
AT31;41731;Regau;2015;6004;357;154;15;52;6582
AT31;41732;Rüstorf;2015;1923;51;52;5;25;2056
AT31;41733;Rutzenham;2015;263;6;4;0;5;278
AT31;41734;St. Georgen im Attergau;2015;3742;252;168;25;273;4460
AT31;41735;St. Lorenz;2015;2228;155;13;13;21;2430
AT31;41736;Schlatt;2015;1209;56;13;7;5;1290
AT31;41737;Schörfling am Attersee;2015;3166;156;32;1;29;3384
AT31;41738;Schwanenstadt;2015;3476;321;268;80;129;4274
AT31;41739;Seewalchen am Attersee;2015;5097;229;64;2;72;5464
AT31;41740;Steinbach am Attersee;2015;775;68;2;0;23;868
AT31;41741;Straß im Attergau;2015;1339;66;16;9;45;1475
AT31;41742;Tiefgraben;2015;3567;260;38;3;94;3962
AT31;41743;Timelkam;2015;5202;226;224;22;252;5926
AT31;41744;Ungenach;2015;1423;34;0;0;39;1496
AT31;41745;Unterach am Attersee;2015;1259;140;40;5;17;1461
AT31;41746;Vöcklabruck;2015;10200;756;522;90;611;12179
AT31;41747;Vöcklamarkt;2015;4353;237;155;43;65;4853
AT31;41748;Weißenkirchen im Attergau;2015;920;29;0;0;0;949
AT31;41749;Weyregg am Attersee;2015;1450;49;4;0;14;1517
AT31;41750;Wolfsegg am Hausruck;2015;1813;148;4;4;55;2024
AT31;41751;Zell am Moos;2015;1430;81;16;12;50;1589
AT31;41752;Zell am Pettenfirst;2015;1153;38;3;1;11;1206
AT31;41801;Aichkirchen;2015;539;9;10;4;1;563
AT31;41802;Bachmanning;2015;608;53;4;11;1;677
AT31;41803;Bad Wimsbach-Neydharting;2015;2351;54;29;27;20;2481
AT31;41804;Buchkirchen;2015;3907;105;18;12;18;4060
AT31;41805;Eberstalzell;2015;2426;64;53;3;17;2563
AT31;41806;Edt bei Lambach;2015;1975;79;59;13;12;2138
AT31;41807;Fischlham;2015;1293;20;0;2;4;1319
AT31;41808;Gunskirchen;2015;5424;317;75;11;28;5855
AT31;41809;Holzhausen;2015;859;53;2;1;3;918
AT31;41810;Krenglbach;2015;2958;66;29;7;16;3076
AT31;41811;Lambach;2015;2771;262;227;37;81;3378
AT31;41812;Marchtrenk;2015;11210;1045;335;224;137;12951
AT31;41813;Neukirchen bei Lambach;2015;865;28;6;3;5;907
AT31;41814;Offenhausen;2015;1490;88;11;21;5;1615
AT31;41815;Pennewang;2015;874;26;1;0;0;901
AT31;41816;Pichl bei Wels;2015;2597;118;22;49;25;2811
AT31;41817;Sattledt;2015;2282;133;61;68;62;2606
AT31;41818;Schleißheim;2015;1233;62;4;1;12;1312
AT31;41819;Sipbachzell;2015;1848;57;11;8;10;1934
AT31;41820;Stadl-Paura;2015;4092;350;327;58;130;4957
AT31;41821;Steinerkirchen an der Traun;2015;2265;69;18;3;24;2379
AT31;41822;Steinhaus;2015;1909;57;20;1;9;1996
AT31;41823;Thalheim bei Wels;2015;4917;355;117;35;74;5498
AT31;41824;Weißkirchen an der Traun;2015;3097;132;22;30;65;3346
AT31;40101;Linz;2014;160327;14254;10449;3346;9051;197427
AT31;40201;Steyr;2014;32194;2002;2366;881;844;38287
AT31;40301;Wels;2014;46914;4745;4978;1531;1690;59858
AT31;40401;Altheim;2014;4286;295;158;14;14;4767
AT31;40402;Aspach;2014;2336;123;12;0;7;2478
AT31;40403;Auerbach;2014;514;35;9;0;8;566
AT31;40404;Braunau am Inn;2014;13339;1361;1005;141;541;16387
AT31;40405;Burgkirchen;2014;2396;111;56;1;12;2576
AT31;40406;Eggelsberg;2014;2129;133;27;1;14;2304
AT31;40407;Feldkirchen bei Mattighofen;2014;1828;60;10;0;10;1908
AT31;40408;Franking;2014;829;92;21;0;0;942
AT31;40409;Geretsberg;2014;997;70;3;0;47;1117
AT31;40410;Gilgenberg am Weilhart;2014;1186;88;6;0;14;1294
AT31;40411;Haigermoos;2014;555;24;0;0;1;580
AT31;40412;Handenberg;2014;1239;60;11;0;3;1313
AT31;40413;Helpfau-Uttendorf;2014;2842;347;214;15;22;3440
AT31;40414;Hochburg-Ach;2014;2490;618;11;1;17;3137
AT31;40415;Höhnhart;2014;1362;45;0;0;3;1410
AT31;40416;Jeging;2014;630;37;13;18;0;698
AT31;40417;Kirchberg bei Mattighofen;2014;1078;40;2;15;5;1140
AT31;40418;Lengau;2014;4144;199;100;44;16;4503
AT31;40419;Lochen am See;2014;2520;76;6;5;5;2612
AT31;40420;Maria Schmolln;2014;1365;32;4;1;34;1436
AT31;40421;Mattighofen;2014;4399;524;906;108;83;6020
AT31;40422;Mauerkirchen;2014;1869;258;228;0;61;2416
AT31;40423;Mining;2014;1103;54;7;0;5;1169
AT31;40424;Moosbach;2014;895;41;2;0;5;943
AT31;40425;Moosdorf;2014;1493;105;8;0;5;1611
AT31;40426;Munderfing;2014;2644;137;94;19;12;2906
AT31;40427;Neukirchen an der Enknach;2014;2018;76;21;3;19;2137
AT31;40428;Ostermiething;2014;2850;270;82;9;65;3276
AT31;40429;Palting;2014;883;24;3;0;3;913
AT31;40430;Perwang am Grabensee;2014;903;56;1;0;2;962
AT31;40431;Pfaffstätt;2014;874;80;29;0;8;991
AT31;40432;Pischelsdorf am Engelbach;2014;1542;107;2;4;7;1662
AT31;40433;Polling im Innkreis;2014;895;35;23;0;4;957
AT31;40434;Roßbach;2014;911;29;0;0;2;942
AT31;40435;St. Georgen am Fillmannsbach;2014;380;9;0;0;1;390
AT31;40436;St. Johann am Walde;2014;1953;74;2;1;6;2036
AT31;40437;St. Pantaleon;2014;2671;212;118;7;26;3034
AT31;40438;St. Peter am Hart;2014;2156;197;22;9;65;2449
AT31;40439;St. Radegund;2014;549;38;2;0;0;589
AT31;40440;St. Veit im Innkreis;2014;402;19;1;1;2;425
AT31;40441;Schalchen;2014;3324;190;237;9;18;3778
AT31;40442;Schwand im Innkreis;2014;859;32;0;0;5;896
AT31;40443;Tarsdorf;2014;1869;137;7;0;6;2019
AT31;40444;Treubach;2014;680;29;4;0;5;718
AT31;40445;Überackern;2014;494;182;0;0;3;679
AT31;40446;Weng im Innkreis;2014;1310;51;5;0;11;1377
AT31;40501;Alkoven;2014;5296;172;95;34;28;5625
AT31;40502;Aschach an der Donau;2014;1925;76;176;2;15;2194
AT31;40503;Eferding;2014;3370;150;400;22;29;3971
AT31;40504;Fraham;2014;2215;59;53;0;8;2335
AT31;40505;Haibach ob der Donau;2014;1275;18;1;0;2;1296
AT31;40506;Hartkirchen;2014;3920;39;69;6;10;4044
AT31;40507;Hinzenbach;2014;1868;25;81;2;1;1977
AT31;40508;Prambachkirchen;2014;2682;72;30;8;7;2799
AT31;40509;Pupping;2014;1818;29;22;1;4;1874
AT31;40510;St. Marienkirchen an der Polsenz;2014;2195;39;23;16;4;2277
AT31;40511;Scharten;2014;2115;45;45;9;50;2264
AT31;40512;Stroheim;2014;1535;14;0;0;4;1553
AT31;40601;Freistadt;2014;6969;156;35;225;110;7495
AT31;40602;Grünbach;2014;1855;27;0;0;3;1885
AT31;40603;Gutau;2014;2638;34;0;0;48;2720
AT31;40604;Hagenberg im Mühlkreis;2014;2579;60;2;0;23;2664
AT31;40605;Hirschbach im Mühlkreis;2014;1134;14;1;0;1;1150
AT31;40606;Kaltenberg;2014;625;3;0;0;0;628
AT31;40607;Kefermarkt;2014;2009;46;4;0;11;2070
AT31;40608;Königswiesen;2014;3129;17;2;0;3;3151
AT31;40609;Lasberg;2014;2700;30;3;10;5;2748
AT31;40610;Leopoldschlag;2014;993;15;0;20;0;1028
AT31;40611;Liebenau;2014;1629;8;1;0;1;1639
AT31;40612;Neumarkt im Mühlkreis;2014;3065;43;1;0;11;3120
AT31;40613;Pierbach;2014;972;11;0;1;8;992
AT31;40614;Pregarten;2014;4979;111;34;16;29;5169
AT31;40615;Rainbach im Mühlkreis;2014;2800;57;3;28;8;2896
AT31;40616;Sandl;2014;1378;13;1;0;3;1395
AT31;40617;St. Leonhard bei Freistadt;2014;1370;5;0;0;6;1381
AT31;40618;St. Oswald bei Freistadt;2014;2780;29;7;3;7;2826
AT31;40619;Schönau im Mühlkreis;2014;1914;11;0;0;1;1926
AT31;40620;Tragwein;2014;2981;45;8;0;15;3049
AT31;40621;Unterweißenbach;2014;2244;14;0;5;4;2267
AT31;40622;Unterweitersdorf;2014;2004;21;6;3;8;2042
AT31;40623;Waldburg;2014;1342;18;0;7;1;1368
AT31;40624;Wartberg ob der Aist;2014;4062;60;3;2;52;4179
AT31;40625;Weitersfelden;2014;1003;29;1;0;2;1035
AT31;40626;Windhaag bei Freistadt;2014;1542;11;2;33;21;1609
AT31;40627;Bad Zell;2014;2711;24;18;4;72;2829
AT31;40701;Altmünster;2014;9069;400;105;15;111;9700
AT31;40702;Bad Goisern am Hallstättersee;2014;7073;345;21;9;39;7487
AT31;40703;Bad Ischl;2014;12302;904;184;208;225;13823
AT31;40704;Ebensee am Traunsee;2014;7243;283;108;6;39;7679
AT31;40705;Gmunden;2014;11286;901;605;101;212;13105
AT31;40706;Gosau;2014;1654;73;8;0;7;1742
AT31;40707;Grünau im Almtal;2014;1918;88;15;20;45;2086
AT31;40708;Gschwandt;2014;2601;57;18;1;9;2686
AT31;40709;Hallstatt;2014;693;70;10;0;6;779
AT31;40710;Kirchham;2014;1944;38;0;17;6;2005
AT31;40711;Laakirchen;2014;8561;333;674;53;56;9677
AT31;40712;Obertraun;2014;648;60;0;0;33;741
AT31;40713;Ohlsdorf;2014;4766;162;109;12;12;5061
AT31;40714;Pinsdorf;2014;3458;193;132;9;17;3809
AT31;40715;Roitham am Traunfall;2014;1909;48;15;8;5;1985
AT31;40716;St. Konrad;2014;1065;35;0;0;1;1101
AT31;40717;St. Wolfgang im Salzkammergut;2014;2575;139;62;7;20;2803
AT31;40718;Traunkirchen;2014;1512;67;14;6;9;1608
AT31;40719;Scharnstein;2014;4442;197;66;29;12;4746
AT31;40720;Vorchdorf;2014;6811;165;160;145;20;7301
AT31;40801;Aistersheim;2014;789;48;6;1;8;852
AT31;40802;Bad Schallerbach;2014;3417;235;136;16;23;3827
AT31;40804;Eschenau im Hausruckkreis;2014;1020;12;0;0;6;1038
AT31;40805;Gallspach;2014;2145;260;182;58;104;2749
AT31;40806;Gaspoltshofen;2014;3310;139;41;18;24;3532
AT31;40807;Geboltskirchen;2014;1366;31;5;3;12;1417
AT31;40808;Grieskirchen;2014;4120;283;132;276;31;4842
AT31;40809;Haag am Hausruck;2014;1976;79;65;6;43;2169
AT31;40810;Heiligenberg;2014;654;12;0;0;3;669
AT31;40811;Hofkirchen an der Trattnach;2014;1505;70;47;0;3;1625
AT31;40812;Kallham;2014;2369;54;24;12;3;2462
AT31;40813;Kematen am Innbach;2014;1261;59;8;27;4;1359
AT31;40814;Meggenhofen;2014;1410;36;1;1;5;1453
AT31;40815;Michaelnbach;2014;1247;15;0;0;4;1266
AT31;40816;Natternbach;2014;2298;33;0;3;16;2350
AT31;40817;Neukirchen am Walde;2014;1582;24;9;1;9;1625
AT31;40818;Neumarkt im Hausruckkreis;2014;1278;44;17;82;3;1424
AT31;40820;Pötting;2014;533;2;0;0;0;535
AT31;40821;Pollham;2014;940;13;1;0;6;960
AT31;40822;Pram;2014;1660;37;11;0;4;1712
AT31;40823;Rottenbach;2014;1022;31;12;0;5;1070
AT31;40824;St. Agatha;2014;2091;18;0;0;2;2111
AT31;40825;St. Georgen bei Grieskirchen;2014;1218;28;3;12;1;1262
AT31;40826;St. Thomas;2014;535;13;0;0;0;548
AT31;40827;Schlüßlberg;2014;2871;85;38;27;10;3031
AT31;40828;Steegen;2014;1032;6;0;0;1;1039
AT31;40829;Taufkirchen an der Trattnach;2014;1916;26;6;3;4;1955
AT31;40830;Tollet;2014;888;17;0;0;1;906
AT31;40831;Waizenkirchen;2014;3426;101;71;32;12;3642
AT31;40832;Wallern an der Trattnach;2014;2792;112;29;22;14;2969
AT31;40833;Weibern;2014;1572;32;66;6;2;1678
AT31;40834;Wendling;2014;809;7;1;6;2;825
AT31;40835;Peuerbach;2014;4278;90;41;54;13;4476
AT31;40901;Edlbach;2014;616;23;4;0;0;643
AT31;40902;Grünburg;2014;3455;100;78;138;10;3781
AT31;40903;Hinterstoder;2014;820;65;10;0;6;901
AT31;40904;Inzersdorf im Kremstal;2014;1802;64;12;3;9;1890
AT31;40905;Kirchdorf an der Krems;2014;3693;245;170;53;45;4206
AT31;40906;Klaus an der Pyhrnbahn;2014;984;76;8;0;10;1078
AT31;40907;Kremsmünster;2014;5626;501;260;15;53;6455
AT31;40908;Micheldorf in Oberösterreich;2014;5333;207;147;84;49;5820
AT31;40909;Molln;2014;3262;87;88;104;15;3556
AT31;40910;Nußbach;2014;2153;67;4;2;2;2228
AT31;40911;Oberschlierbach;2014;463;16;2;1;1;483
AT31;40912;Pettenbach;2014;4794;148;67;100;18;5127
AT31;40913;Ried im Traunkreis;2014;2546;71;18;16;6;2657
AT31;40914;Rosenau am Hengstpaß;2014;616;30;24;0;1;671
AT31;40915;Roßleithen;2014;1796;58;28;0;5;1887
AT31;40916;St. Pankraz;2014;317;16;6;0;0;339
AT31;40917;Schlierbach;2014;2683;98;31;7;19;2838
AT31;40918;Spital am Pyhrn;2014;2082;82;34;1;23;2222
AT31;40919;Steinbach am Ziehberg;2014;804;16;4;0;2;826
AT31;40920;Steinbach an der Steyr;2014;1969;39;5;18;4;2035
AT31;40921;Vorderstoder;2014;752;36;1;0;7;796
AT31;40922;Wartberg an der Krems;2014;2742;104;53;30;32;2961
AT31;40923;Windischgarsten;2014;2132;136;116;1;8;2393
AT31;41001;Allhaming;2014;1079;36;1;11;9;1136
AT31;41002;Ansfelden;2014;12779;1194;838;473;549;15833
AT31;41003;Asten;2014;5623;366;168;101;76;6334
AT31;41004;Eggendorf im Traunkreis;2014;807;47;1;6;2;863
AT31;41005;Enns;2014;9577;850;801;212;190;11630
AT31;41006;Hargelsberg;2014;1298;25;2;0;4;1329
AT31;41007;Hörsching;2014;5279;359;89;84;55;5866
AT31;41008;Hofkirchen im Traunkreis;2014;1706;89;1;1;9;1806
AT31;41009;Kematen an der Krems;2014;2429;122;43;19;15;2628
AT31;41010;Kirchberg-Thening;2014;2225;50;22;3;7;2307
AT31;41011;Kronstorf;2014;2970;126;73;14;12;3195
AT31;41012;Leonding;2014;23805;1590;657;276;611;26939
AT31;41013;St. Florian;2014;5787;163;33;4;27;6014
AT31;41014;Neuhofen an der Krems;2014;5492;229;152;27;34;5934
AT31;41015;Niederneukirchen;2014;1914;37;15;0;10;1976
AT31;41016;Oftering;2014;1920;52;26;3;7;2008
AT31;41017;Pasching;2014;6172;410;190;119;80;6971
AT31;41018;Piberbach;2014;1791;70;10;1;10;1882
AT31;41019;Pucking;2014;3650;107;52;12;11;3832
AT31;41020;St. Marien;2014;4438;122;28;38;20;4646
AT31;41021;Traun;2014;19104;1843;1718;613;643;23921
AT31;41022;Wilhering;2014;5545;199;59;2;48;5853
AT31;41101;Allerheiligen im Mühlkreis;2014;1200;5;2;0;7;1214
AT31;41102;Arbing;2014;1333;35;10;10;9;1397
AT31;41103;Baumgartenberg;2014;1590;55;3;2;46;1696
AT31;41104;Dimbach;2014;994;12;0;0;9;1015
AT31;41105;Grein;2014;2769;111;20;1;71;2972
AT31;41106;Katsdorf;2014;2841;75;0;0;9;2925
AT31;41107;Klam;2014;877;12;0;2;1;892
AT31;41108;Bad Kreuzen;2014;2148;24;17;0;178;2367
AT31;41109;Langenstein;2014;2248;87;24;34;72;2465
AT31;41110;Luftenberg an der Donau;2014;3807;95;39;14;23;3978
AT31;41111;Mauthausen;2014;4292;241;106;213;42;4894
AT31;41112;Mitterkirchen im Machland;2014;1654;49;10;13;2;1728
AT31;41113;Münzbach;2014;1599;106;17;6;0;1728
AT31;41114;Naarn im Machlande;2014;3362;107;46;64;12;3591
AT31;41115;Pabneukirchen;2014;1690;15;13;0;0;1718
AT31;41116;Perg;2014;7198;340;264;269;72;8143
AT31;41117;Rechberg;2014;928;17;1;0;1;947
AT31;41118;Ried in der Riedmark;2014;4000;63;5;16;13;4097
AT31;41119;St. Georgen am Walde;2014;2015;8;0;0;24;2047
AT31;41120;St. Georgen an der Gusen;2014;3631;72;17;37;23;3780
AT31;41121;St. Nikola an der Donau;2014;635;46;10;6;142;839
AT31;41122;St. Thomas am Blasenstein;2014;901;8;4;0;4;917
AT31;41123;Saxen;2014;1678;60;13;15;8;1774
AT31;41124;Schwertberg;2014;4719;213;67;133;52;5184
AT31;41125;Waldhausen im Strudengau;2014;2760;35;12;0;90;2897
AT31;41126;Windhaag bei Perg;2014;1356;46;36;5;4;1447
AT31;41201;Andrichsfurt;2014;730;10;0;1;3;744
AT31;41202;Antiesenhofen;2014;930;83;35;9;1;1058
AT31;41203;Aurolzmünster;2014;2660;76;48;67;20;2871
AT31;41204;Eberschwang;2014;3182;98;60;6;11;3357
AT31;41205;Eitzing;2014;728;15;1;7;1;752
AT31;41206;Geiersberg;2014;517;5;3;0;0;525
AT31;41207;Geinberg;2014;1302;76;17;8;9;1412
AT31;41208;Gurten;2014;1064;36;18;15;6;1139
AT31;41209;Hohenzell;2014;2033;48;27;8;4;2120
AT31;41210;Kirchdorf am Inn;2014;568;42;0;0;1;611
AT31;41211;Kirchheim im Innkreis;2014;693;18;2;0;6;719
AT31;41212;Lambrechten;2014;1253;25;4;0;2;1284
AT31;41213;Lohnsburg am Kobernaußerwald;2014;2128;65;0;2;8;2203
AT31;41214;Mehrnbach;2014;2169;73;23;12;9;2286
AT31;41215;Mettmach;2014;2320;44;0;3;2;2369
AT31;41216;Mörschwang;2014;299;15;0;0;8;322
AT31;41217;Mühlheim am Inn;2014;609;47;0;1;5;662
AT31;41218;Neuhofen im Innkreis;2014;2182;87;22;7;11;2309
AT31;41219;Obernberg am Inn;2014;1273;197;31;7;13;1521
AT31;41220;Ort im Innkreis;2014;1121;63;25;16;7;1232
AT31;41221;Pattigham;2014;866;11;4;0;0;881
AT31;41222;Peterskirchen;2014;647;10;0;1;0;658
AT31;41223;Pramet;2014;959;32;11;0;1;1003
AT31;41224;Reichersberg;2014;1337;125;25;12;30;1529
AT31;41225;Ried im Innkreis;2014;9594;681;514;485;142;11416
AT31;41226;St. Georgen bei Obernberg am Inn;2014;519;23;9;1;0;552
AT31;41227;St. Marienkirchen am Hausruck;2014;823;11;6;0;4;844
AT31;41228;St. Martin im Innkreis;2014;1567;251;69;7;11;1905
AT31;41229;Schildorn;2014;1148;25;0;0;3;1176
AT31;41230;Senftenbach;2014;715;32;4;9;14;774
AT31;41231;Taiskirchen im Innkreis;2014;2353;45;1;4;4;2407
AT31;41232;Tumeltsham;2014;1474;25;38;12;3;1552
AT31;41233;Utzenaich;2014;1449;63;25;2;5;1544
AT31;41234;Waldzell;2014;2080;46;3;4;56;2189
AT31;41235;Weilbach;2014;585;31;0;0;1;617
AT31;41236;Wippenham;2014;535;15;4;2;1;557
AT31;41304;Altenfelden;2014;2084;16;1;13;14;2128
AT31;41305;Arnreit;2014;1123;4;9;0;5;1141
AT31;41306;Atzesberg;2014;435;4;0;0;0;439
AT31;41307;Auberg;2014;542;5;0;0;5;552
AT31;41309;Haslach an der Mühl;2014;2413;52;7;20;29;2521
AT31;41311;Hörbich;2014;407;5;1;0;0;413
AT31;41312;Hofkirchen im Mühlkreis;2014;1415;43;0;0;7;1465
AT31;41313;Julbach;2014;1507;36;0;0;2;1545
AT31;41314;Kirchberg ob der Donau;2014;1022;23;0;0;1;1046
AT31;41315;Klaffer am Hochficht;2014;1237;48;6;0;34;1325
AT31;41316;Kleinzell im Mühlkreis;2014;1491;15;0;6;5;1517
AT31;41317;Kollerschlag;2014;1430;43;0;2;4;1479
AT31;41318;Lembach im Mühlkreis;2014;1452;28;24;1;27;1532
AT31;41319;Lichtenau im Mühlkreis;2014;501;10;0;0;1;512
AT31;41320;Nebelberg;2014;619;14;0;0;0;633
AT31;41321;Neufelden;2014;1135;27;51;1;78;1292
AT31;41322;Niederkappel;2014;966;8;0;0;2;976
AT31;41323;Niederwaldkirchen;2014;1736;21;0;5;7;1769
AT31;41324;Oberkappel;2014;648;41;0;0;61;750
AT31;41325;Oepping;2014;1488;4;5;0;0;1497
AT31;41326;Peilstein im Mühlviertel;2014;1524;24;0;0;1;1549
AT31;41327;Pfarrkirchen im Mühlkreis;2014;1401;51;0;0;24;1476
AT31;41328;Putzleinsdorf;2014;1481;31;17;0;6;1535
AT31;41329;Neustift im Mühlkreis;2014;1372;48;0;0;2;1422
AT31;41331;St. Johann am Wimberg;2014;994;15;0;2;5;1016
AT31;41332;St. Martin im Mühlkreis;2014;3534;51;6;38;9;3638
AT31;41333;St. Oswald bei Haslach;2014;507;10;0;0;0;517
AT31;41334;St. Peter am Wimberg;2014;1750;18;0;2;2;1772
AT31;41336;St. Ulrich im Mühlkreis;2014;637;3;0;3;4;647
AT31;41337;St. Veit im Mühlkreis;2014;1172;12;2;0;3;1189
AT31;41338;Sarleinsbach;2014;2228;28;0;0;8;2264
AT31;41341;Schwarzenberg am Böhmerwald;2014;543;74;2;0;26;645
AT31;41342;Ulrichsberg;2014;2731;87;9;0;24;2851
AT31;41343;Aigen-Schlägl;2014;3005;59;23;2;23;3112
AT31;41344;Rohrbach-Berg;2014;4795;149;68;18;44;5074
AT31;41345;Helfenberg;2014;1483;29;4;22;6;1544
AT31;41346;St. Stefan-Afiesl;2014;1067;21;0;0;3;1091
AT31;41401;Altschwendt;2014;655;11;0;2;4;672
AT31;41402;Andorf;2014;4858;124;51;76;21;5130
AT31;41403;Brunnenthal;2014;1833;140;12;14;13;2012
AT31;41404;Diersbach;2014;1480;45;0;2;5;1532
AT31;41405;Dorf an der Pram;2014;1027;17;3;1;1;1049
AT31;41406;Eggerding;2014;1249;30;0;1;6;1286
AT31;41407;Engelhartszell;2014;865;63;3;0;41;972
AT31;41408;Enzenkirchen;2014;1728;57;0;0;8;1793
AT31;41409;Esternberg;2014;2719;146;1;1;4;2871
AT31;41410;Freinberg;2014;1125;309;9;0;6;1449
AT31;41411;Kopfing im Innkreis;2014;1886;49;1;2;10;1948
AT31;41412;Mayrhof;2014;290;5;0;0;1;296
AT31;41413;Münzkirchen;2014;2455;53;7;0;14;2529
AT31;41414;Raab;2014;2138;83;13;28;2;2264
AT31;41415;Rainbach im Innkreis;2014;1451;32;1;9;12;1505
AT31;41416;Riedau;2014;1864;59;26;69;16;2034
AT31;41417;St. Aegidi;2014;1534;36;3;0;6;1579
AT31;41418;St. Florian am Inn;2014;2824;152;11;71;10;3068
AT31;41419;St. Marienkirchen bei Schärding;2014;1719;61;0;35;10;1825
AT31;41420;St. Roman;2014;1713;26;1;0;1;1741
AT31;41421;St. Willibald;2014;1078;31;1;0;1;1111
AT31;41422;Schärding;2014;4194;375;123;158;68;4918
AT31;41423;Schardenberg;2014;2067;289;6;0;18;2380
AT31;41424;Sigharting;2014;772;21;0;2;3;798
AT31;41425;Suben;2014;1166;134;30;34;61;1425
AT31;41426;Taufkirchen an der Pram;2014;2726;85;6;66;13;2896
AT31;41427;Vichtenstein;2014;554;77;6;0;29;666
AT31;41428;Waldkirchen am Wesen;2014;1144;29;1;0;5;1179
AT31;41429;Wernstein am Inn;2014;1378;127;3;0;67;1575
AT31;41430;Zell an der Pram;2014;1895;83;9;29;9;2025
AT31;41501;Adlwang;2014;1685;46;5;3;5;1744
AT31;41502;Aschach an der Steyr;2014;2163;20;5;0;6;2194
AT31;41503;Bad Hall;2014;4424;224;87;85;35;4855
AT31;41504;Dietach;2014;2856;110;65;6;11;3048
AT31;41505;Gaflenz;2014;1847;40;6;0;3;1896
AT31;41506;Garsten;2014;6307;157;62;26;83;6635
AT31;41507;Großraming;2014;2634;28;12;0;50;2724
AT31;41508;Laussa;2014;1240;10;0;0;1;1251
AT31;41509;Losenstein;2014;1538;44;7;0;3;1592
AT31;41510;Maria Neustift;2014;1585;6;0;0;9;1600
AT31;41511;Pfarrkirchen bei Bad Hall;2014;2095;43;11;6;9;2164
AT31;41512;Reichraming;2014;1699;31;7;0;5;1742
AT31;41513;Rohr im Kremstal;2014;1178;31;16;1;4;1230
AT31;41514;St. Ulrich bei Steyr;2014;2947;37;8;7;16;3015
AT31;41515;Schiedlberg;2014;1168;37;0;1;8;1214
AT31;41516;Sierning;2014;8550;284;192;86;101;9213
AT31;41517;Ternberg;2014;3257;65;2;2;14;3340
AT31;41518;Waldneukirchen;2014;2185;41;13;11;8;2258
AT31;41521;Wolfern;2014;2975;53;4;2;7;3041
AT31;41522;Weyer;2014;3992;103;30;4;32;4161
AT31;41601;Alberndorf in der Riedmark;2014;3869;62;5;1;11;3948
AT31;41602;Altenberg bei Linz;2014;4370;69;4;0;24;4467
AT31;41603;Bad Leonfelden;2014;3896;114;34;19;42;4105
AT31;41604;Eidenberg;2014;1987;42;1;0;10;2040
AT31;41605;Engerwitzdorf;2014;8379;173;21;4;37;8614
AT31;41606;Feldkirchen an der Donau;2014;5108;81;61;9;27;5286
AT31;41607;Gallneukirchen;2014;5903;172;54;12;58;6199
AT31;41608;Goldwörth;2014;902;8;2;0;6;918
AT31;41609;Gramastetten;2014;4799;107;4;5;50;4965
AT31;41610;Haibach im Mühlkreis;2014;846;24;0;0;2;872
AT31;41611;Hellmonsödt;2014;2088;62;9;9;15;2183
AT31;41612;Herzogsdorf;2014;2405;23;0;0;11;2439
AT31;41613;Kirchschlag bei Linz;2014;1935;85;2;0;23;2045
AT31;41614;Lichtenberg;2014;2606;45;0;1;12;2664
AT31;41615;Oberneukirchen;2014;3046;61;11;2;16;3136
AT31;41616;Ottenschlag im Mühlkreis;2014;520;11;0;0;2;533
AT31;41617;Ottensheim;2014;4241;149;34;8;83;4515
AT31;41618;Puchenau;2014;4200;149;13;5;47;4414
AT31;41619;Reichenau im Mühlkreis;2014;1239;25;2;2;26;1294
AT31;41620;Reichenthal;2014;1436;40;2;1;40;1519
AT31;41621;St. Gotthard im Mühlkreis;2014;1226;38;0;0;6;1270
AT31;41622;Schenkenfelden;2014;1534;21;5;0;4;1564
AT31;41623;Sonnberg im Mühlkreis;2014;912;5;0;0;2;919
AT31;41624;Steyregg;2014;4614;198;42;5;160;5019
AT31;41626;Walding;2014;3844;80;20;12;63;4019
AT31;41627;Zwettl an der Rodl;2014;1713;29;0;8;61;1811
AT31;41628;Vorderweißenbach;2014;2543;37;3;5;3;2591
AT31;41701;Ampflwang im Hausruckwald;2014;3096;170;37;17;89;3409
AT31;41702;Attersee am Attersee;2014;1474;90;5;0;40;1609
AT31;41703;Attnang-Puchheim;2014;6857;766;640;294;201;8758
AT31;41704;Atzbach;2014;1125;39;2;0;3;1169
AT31;41705;Aurach am Hongar;2014;1609;45;6;4;5;1669
AT31;41706;Berg im Attergau;2014;977;25;4;0;7;1013
AT31;41707;Desselbrunn;2014;1729;38;17;0;7;1791
AT31;41708;Fornach;2014;926;23;0;0;0;949
AT31;41709;Frankenburg am Hausruck;2014;4609;146;63;10;13;4841
AT31;41710;Frankenmarkt;2014;3288;215;84;42;37;3666
AT31;41711;Gampern;2014;2713;70;13;0;16;2812
AT31;41712;Innerschwand am Mondsee;2014;1045;52;3;0;5;1105
AT31;41713;Lenzing;2014;4498;213;139;23;101;4974
AT31;41714;Manning;2014;818;6;0;0;1;825
AT31;41715;Mondsee;2014;2827;411;191;10;89;3528
AT31;41716;Neukirchen an der Vöckla;2014;2455;70;12;1;6;2544
AT31;41717;Niederthalheim;2014;1033;17;0;11;8;1069
AT31;41718;Nußdorf am Attersee;2014;1048;69;16;0;19;1152
AT31;41719;Oberhofen am Irrsee;2014;1468;92;5;1;10;1576
AT31;41720;Oberndorf bei Schwanenstadt;2014;1358;26;27;4;5;1420
AT31;41721;Oberwang;2014;1590;35;4;1;5;1635
AT31;41722;Ottnang am Hausruck;2014;3642;182;9;8;14;3855
AT31;41723;Pfaffing;2014;1422;25;0;0;3;1450
AT31;41724;Pilsbach;2014;596;11;0;0;2;609
AT31;41725;Pitzenberg;2014;501;5;0;0;2;508
AT31;41726;Pöndorf;2014;2185;83;6;13;7;2294
AT31;41727;Puchkirchen am Trattberg;2014;962;42;4;0;0;1008
AT31;41728;Pühret;2014;600;8;1;0;0;609
AT31;41729;Redleiten;2014;486;12;0;1;0;499
AT31;41730;Redlham;2014;1390;44;31;3;17;1485
AT31;41731;Regau;2014;5974;332;142;17;41;6506
AT31;41732;Rüstorf;2014;1899;51;51;9;9;2019
AT31;41733;Rutzenham;2014;261;6;4;0;0;271
AT31;41734;St. Georgen im Attergau;2014;3663;216;205;24;268;4376
AT31;41735;St. Lorenz;2014;2228;157;13;14;18;2430
AT31;41736;Schlatt;2014;1214;46;15;8;5;1288
AT31;41737;Schörfling am Attersee;2014;3107;179;29;1;22;3338
AT31;41738;Schwanenstadt;2014;3438;274;263;78;102;4155
AT31;41739;Seewalchen am Attersee;2014;5114;207;62;3;40;5426
AT31;41740;Steinbach am Attersee;2014;788;62;4;0;16;870
AT31;41741;Straß im Attergau;2014;1339;66;19;10;40;1474
AT31;41742;Tiefgraben;2014;3527;254;28;3;36;3848
AT31;41743;Timelkam;2014;5267;209;239;24;190;5929
AT31;41744;Ungenach;2014;1409;22;0;0;12;1443
AT31;41745;Unterach am Attersee;2014;1272;117;41;5;15;1450
AT31;41746;Vöcklabruck;2014;10199;690;507;81;494;11971
AT31;41747;Vöcklamarkt;2014;4357;201;128;48;41;4775
AT31;41748;Weißenkirchen im Attergau;2014;911;31;0;0;0;942
AT31;41749;Weyregg am Attersee;2014;1430;48;4;0;4;1486
AT31;41750;Wolfsegg am Hausruck;2014;1815;137;3;0;48;2003
AT31;41751;Zell am Moos;2014;1424;71;20;12;39;1566
AT31;41752;Zell am Pettenfirst;2014;1119;42;3;0;11;1175
AT31;41801;Aichkirchen;2014;540;9;10;3;1;563
AT31;41802;Bachmanning;2014;598;47;4;12;1;662
AT31;41803;Bad Wimsbach-Neydharting;2014;2346;57;25;21;5;2454
AT31;41804;Buchkirchen;2014;3922;99;16;13;13;4063
AT31;41805;Eberstalzell;2014;2361;58;49;5;13;2486
AT31;41806;Edt bei Lambach;2014;1900;71;51;12;8;2042
AT31;41807;Fischlham;2014;1299;17;0;2;5;1323
AT31;41808;Gunskirchen;2014;5390;301;76;13;14;5794
AT31;41809;Holzhausen;2014;773;40;2;1;5;821
AT31;41810;Krenglbach;2014;2931;64;26;7;15;3043
AT31;41811;Lambach;2014;2750;220;236;34;60;3300
AT31;41812;Marchtrenk;2014;11165;914;335;216;107;12737
AT31;41813;Neukirchen bei Lambach;2014;863;19;4;3;4;893
AT31;41814;Offenhausen;2014;1510;74;10;21;5;1620
AT31;41815;Pennewang;2014;870;22;1;0;0;893
AT31;41816;Pichl bei Wels;2014;2594;111;26;41;19;2791
AT31;41817;Sattledt;2014;2258;129;67;65;49;2568
AT31;41818;Schleißheim;2014;1229;55;4;1;9;1298
AT31;41819;Sipbachzell;2014;1833;54;14;9;10;1920
AT31;41820;Stadl-Paura;2014;4160;301;314;64;114;4953
AT31;41821;Steinerkirchen an der Traun;2014;2269;62;17;3;26;2377
AT31;41822;Steinhaus;2014;1884;56;10;1;11;1962
AT31;41823;Thalheim bei Wels;2014;4924;326;121;48;47;5466
AT31;41824;Weißkirchen an der Traun;2014;3062;114;19;32;60;3287
AT31;40101;Linz;2013;160024;12311;10055;3197;8227;193814
AT31;40201;Steyr;2013;32377;1766;2334;872;771;38120
AT31;40301;Wels;2013;47352;4117;4803;1544;1523;59339
AT31;40401;Altheim;2013;4320;225;158;14;10;4727
AT31;40402;Aspach;2013;2344;102;11;0;5;2462
AT31;40403;Auerbach;2013;491;27;10;0;10;538
AT31;40404;Braunau am Inn;2013;13480;1165;970;142;498;16255
AT31;40405;Burgkirchen;2013;2389;118;43;1;12;2563
AT31;40406;Eggelsberg;2013;2106;129;31;1;16;2283
AT31;40407;Feldkirchen bei Mattighofen;2013;1838;47;9;0;10;1904
AT31;40408;Franking;2013;829;78;17;0;1;925
AT31;40409;Geretsberg;2013;1000;60;6;0;48;1114
AT31;40410;Gilgenberg am Weilhart;2013;1177;80;6;0;9;1272
AT31;40411;Haigermoos;2013;548;23;0;0;3;574
AT31;40412;Handenberg;2013;1249;58;10;0;3;1320
AT31;40413;Helpfau-Uttendorf;2013;2826;252;207;13;21;3319
AT31;40414;Hochburg-Ach;2013;2505;593;10;1;17;3126
AT31;40415;Höhnhart;2013;1358;35;1;0;4;1398
AT31;40416;Jeging;2013;629;25;10;13;2;679
AT31;40417;Kirchberg bei Mattighofen;2013;1094;30;1;12;8;1145
AT31;40418;Lengau;2013;4125;155;114;47;15;4456
AT31;40419;Lochen am See;2013;2469;77;7;3;5;2561
AT31;40420;Maria Schmolln;2013;1331;33;0;1;4;1369
AT31;40421;Mattighofen;2013;4386;458;899;105;74;5922
AT31;40422;Mauerkirchen;2013;1859;209;232;0;10;2310
AT31;40423;Mining;2013;1094;55;7;0;5;1161
AT31;40424;Moosbach;2013;901;29;2;0;5;937
AT31;40425;Moosdorf;2013;1468;95;8;6;5;1582
AT31;40426;Munderfing;2013;2612;120;103;12;11;2858
AT31;40427;Neukirchen an der Enknach;2013;2009;66;20;2;20;2117
AT31;40428;Ostermiething;2013;2836;262;78;8;23;3207
AT31;40429;Palting;2013;881;22;9;0;3;915
AT31;40430;Perwang am Grabensee;2013;896;51;0;0;2;949
AT31;40431;Pfaffstätt;2013;856;83;27;6;9;981
AT31;40432;Pischelsdorf am Engelbach;2013;1568;79;4;4;7;1662
AT31;40433;Polling im Innkreis;2013;898;25;24;0;6;953
AT31;40434;Roßbach;2013;920;26;1;0;1;948
AT31;40435;St. Georgen am Fillmannsbach;2013;384;8;0;0;1;393
AT31;40436;St. Johann am Walde;2013;1951;72;3;1;4;2031
AT31;40437;St. Pantaleon;2013;2745;214;111;11;31;3112
AT31;40438;St. Peter am Hart;2013;2141;197;19;10;47;2414
AT31;40439;St. Radegund;2013;533;39;2;0;0;574
AT31;40440;St. Veit im Innkreis;2013;398;14;0;1;1;414
AT31;40441;Schalchen;2013;3343;162;227;4;17;3753
AT31;40442;Schwand im Innkreis;2013;852;23;0;0;5;880
AT31;40443;Tarsdorf;2013;1889;123;5;0;5;2022
AT31;40444;Treubach;2013;681;38;4;0;6;729
AT31;40445;Überackern;2013;493;165;0;0;3;661
AT31;40446;Weng im Innkreis;2013;1298;57;4;0;8;1367
AT31;40501;Alkoven;2013;5217;161;88;31;26;5523
AT31;40502;Aschach an der Donau;2013;1934;75;163;3;15;2190
AT31;40503;Eferding;2013;3359;130;379;22;30;3920
AT31;40504;Fraham;2013;2183;58;50;0;5;2296
AT31;40505;Haibach ob der Donau;2013;1287;13;1;0;2;1303
AT31;40506;Hartkirchen;2013;3922;39;80;7;13;4061
AT31;40507;Hinzenbach;2013;1877;23;65;3;5;1973
AT31;40508;Prambachkirchen;2013;2692;65;29;4;7;2797
AT31;40509;Pupping;2013;1828;24;21;1;6;1880
AT31;40510;St. Marienkirchen an der Polsenz;2013;2183;32;19;17;3;2254
AT31;40511;Scharten;2013;2062;34;45;4;58;2203
AT31;40512;Stroheim;2013;1541;15;0;0;5;1561
AT31;40601;Freistadt;2013;6976;137;36;211;105;7465
AT31;40602;Grünbach;2013;1849;27;0;1;3;1880
AT31;40603;Gutau;2013;2634;25;4;0;35;2698
AT31;40604;Hagenberg im Mühlkreis;2013;2578;61;1;0;17;2657
AT31;40605;Hirschbach im Mühlkreis;2013;1138;11;2;0;2;1153
AT31;40606;Kaltenberg;2013;618;3;0;0;0;621
AT31;40607;Kefermarkt;2013;1984;49;3;0;9;2045
AT31;40608;Königswiesen;2013;3137;14;1;0;3;3155
AT31;40609;Lasberg;2013;2713;30;3;10;6;2762
AT31;40610;Leopoldschlag;2013;985;15;0;23;0;1023
AT31;40611;Liebenau;2013;1638;8;1;0;2;1649
AT31;40612;Neumarkt im Mühlkreis;2013;3039;41;1;0;14;3095
AT31;40613;Pierbach;2013;974;12;0;8;5;999
AT31;40614;Pregarten;2013;4964;107;38;14;21;5144
AT31;40615;Rainbach im Mühlkreis;2013;2835;61;2;27;9;2934
AT31;40616;Sandl;2013;1406;10;1;1;4;1422
AT31;40617;St. Leonhard bei Freistadt;2013;1379;15;0;0;6;1400
AT31;40618;St. Oswald bei Freistadt;2013;2768;35;8;2;7;2820
AT31;40619;Schönau im Mühlkreis;2013;1889;10;1;0;1;1901
AT31;40620;Tragwein;2013;3018;48;9;2;12;3089
AT31;40621;Unterweißenbach;2013;2277;12;0;1;3;2293
AT31;40622;Unterweitersdorf;2013;2011;17;5;2;16;2051
AT31;40623;Waldburg;2013;1340;16;0;7;2;1365
AT31;40624;Wartberg ob der Aist;2013;4059;51;3;2;10;4125
AT31;40625;Weitersfelden;2013;1013;28;1;0;2;1044
AT31;40626;Windhaag bei Freistadt;2013;1554;10;2;33;19;1618
AT31;40627;Bad Zell;2013;2702;23;16;3;56;2800
AT31;40701;Altmünster;2013;9026;365;99;15;104;9609
AT31;40702;Bad Goisern am Hallstättersee;2013;7132;318;26;9;42;7527
AT31;40703;Bad Ischl;2013;12338;856;178;214;173;13759
AT31;40704;Ebensee am Traunsee;2013;7299;260;110;6;31;7706
AT31;40705;Gmunden;2013;11341;780;603;99;198;13021
AT31;40706;Gosau;2013;1652;74;10;0;11;1747
AT31;40707;Grünau im Almtal;2013;1909;88;16;20;45;2078
AT31;40708;Gschwandt;2013;2608;57;15;1;10;2691
AT31;40709;Hallstatt;2013;711;59;11;0;7;788
AT31;40710;Kirchham;2013;1920;38;0;15;6;1979
AT31;40711;Laakirchen;2013;8554;297;634;54;60;9599
AT31;40712;Obertraun;2013;656;52;0;0;30;738
AT31;40713;Ohlsdorf;2013;4787;150;109;13;12;5071
AT31;40714;Pinsdorf;2013;3406;180;128;7;18;3739
AT31;40715;Roitham am Traunfall;2013;1911;36;11;7;6;1971
AT31;40716;St. Konrad;2013;1050;29;0;0;1;1080
AT31;40717;St. Wolfgang im Salzkammergut;2013;2584;138;70;6;22;2820
AT31;40718;Traunkirchen;2013;1517;67;18;7;12;1621
AT31;40719;Scharnstein;2013;4445;184;67;29;12;4737
AT31;40720;Vorchdorf;2013;6801;144;155;147;12;7259
AT31;40801;Aistersheim;2013;818;47;5;1;9;880
AT31;40802;Bad Schallerbach;2013;3349;198;131;15;23;3716
AT31;40804;Eschenau im Hausruckkreis;2013;1039;7;0;0;7;1053
AT31;40805;Gallspach;2013;2182;231;147;58;45;2663
AT31;40806;Gaspoltshofen;2013;3313;124;42;18;10;3507
AT31;40807;Geboltskirchen;2013;1356;34;5;3;9;1407
AT31;40808;Grieskirchen;2013;4153;244;135;275;32;4839
AT31;40809;Haag am Hausruck;2013;1995;68;57;7;30;2157
AT31;40810;Heiligenberg;2013;655;8;0;0;0;663
AT31;40811;Hofkirchen an der Trattnach;2013;1480;68;50;1;3;1602
AT31;40812;Kallham;2013;2401;50;24;14;1;2490
AT31;40813;Kematen am Innbach;2013;1260;48;6;27;3;1344
AT31;40814;Meggenhofen;2013;1355;35;1;1;5;1397
AT31;40815;Michaelnbach;2013;1255;11;0;0;4;1270
AT31;40816;Natternbach;2013;2303;40;0;2;14;2359
AT31;40817;Neukirchen am Walde;2013;1598;17;11;0;7;1633
AT31;40818;Neumarkt im Hausruckkreis;2013;1307;42;17;88;3;1457
AT31;40820;Pötting;2013;524;3;0;0;0;527
AT31;40821;Pollham;2013;939;8;1;0;8;956
AT31;40822;Pram;2013;1688;30;8;0;4;1730
AT31;40823;Rottenbach;2013;1025;33;10;0;5;1073
AT31;40824;St. Agatha;2013;2086;16;0;0;2;2104
AT31;40825;St. Georgen bei Grieskirchen;2013;1203;27;3;11;2;1246
AT31;40826;St. Thomas;2013;521;12;0;0;0;533
AT31;40827;Schlüßlberg;2013;2849;70;34;23;10;2986
AT31;40828;Steegen;2013;1036;7;0;0;1;1044
AT31;40829;Taufkirchen an der Trattnach;2013;1911;22;6;2;5;1946
AT31;40830;Tollet;2013;863;19;0;0;2;884
AT31;40831;Waizenkirchen;2013;3409;96;74;28;7;3614
AT31;40832;Wallern an der Trattnach;2013;2768;103;29;22;18;2940
AT31;40833;Weibern;2013;1549;20;66;6;1;1642
AT31;40834;Wendling;2013;792;8;1;6;2;809
AT31;40835;Peuerbach;2013;4283;79;41;51;13;4467
AT31;40901;Edlbach;2013;627;23;5;0;0;655
AT31;40902;Grünburg;2013;3468;94;64;147;9;3782
AT31;40903;Hinterstoder;2013;826;65;11;0;2;904
AT31;40904;Inzersdorf im Kremstal;2013;1837;57;11;3;9;1917
AT31;40905;Kirchdorf an der Krems;2013;3652;215;176;30;47;4120
AT31;40906;Klaus an der Pyhrnbahn;2013;994;68;10;0;9;1081
AT31;40907;Kremsmünster;2013;5656;431;252;14;46;6399
AT31;40908;Micheldorf in Oberösterreich;2013;5342;206;146;86;34;5814
AT31;40909;Molln;2013;3301;82;86;107;14;3590
AT31;40910;Nußbach;2013;2162;62;4;5;0;2233
AT31;40911;Oberschlierbach;2013;446;13;1;1;1;462
AT31;40912;Pettenbach;2013;4755;142;73;103;16;5089
AT31;40913;Ried im Traunkreis;2013;2541;68;18;16;7;2650
AT31;40914;Rosenau am Hengstpaß;2013;632;27;25;0;0;684
AT31;40915;Roßleithen;2013;1816;54;30;0;3;1903
AT31;40916;St. Pankraz;2013;319;19;7;0;0;345
AT31;40917;Schlierbach;2013;2669;82;25;10;19;2805
AT31;40918;Spital am Pyhrn;2013;2056;78;27;1;11;2173
AT31;40919;Steinbach am Ziehberg;2013;799;16;3;0;1;819
AT31;40920;Steinbach an der Steyr;2013;1945;32;5;19;5;2006
AT31;40921;Vorderstoder;2013;743;42;1;0;9;795
AT31;40922;Wartberg an der Krems;2013;2753;101;51;27;12;2944
AT31;40923;Windischgarsten;2013;2138;136;115;1;11;2401
AT31;41001;Allhaming;2013;1045;29;1;11;6;1092
AT31;41002;Ansfelden;2013;12841;992;806;461;558;15658
AT31;41003;Asten;2013;5603;305;160;84;76;6228
AT31;41004;Eggendorf im Traunkreis;2013;774;53;1;7;2;837
AT31;41005;Enns;2013;9619;693;795;228;188;11523
AT31;41006;Hargelsberg;2013;1267;21;2;0;2;1292
AT31;41007;Hörsching;2013;5332;326;92;87;51;5888
AT31;41008;Hofkirchen im Traunkreis;2013;1714;82;1;1;6;1804
AT31;41009;Kematen an der Krems;2013;2426;103;46;19;13;2607
AT31;41010;Kirchberg-Thening;2013;2201;37;20;2;7;2267
AT31;41011;Kronstorf;2013;2996;112;69;14;10;3201
AT31;41012;Leonding;2013;23537;1427;624;286;521;26395
AT31;41013;St. Florian;2013;5822;145;37;5;20;6029
AT31;41014;Neuhofen an der Krems;2013;5379;201;148;31;44;5803
AT31;41015;Niederneukirchen;2013;1897;32;14;0;10;1953
AT31;41016;Oftering;2013;1876;45;26;4;8;1959
AT31;41017;Pasching;2013;6160;386;196;106;76;6924
AT31;41018;Piberbach;2013;1787;68;8;1;9;1873
AT31;41019;Pucking;2013;3652;88;48;18;7;3813
AT31;41020;St. Marien;2013;4464;113;30;37;18;4662
AT31;41021;Traun;2013;19267;1594;1697;606;670;23834
AT31;41022;Wilhering;2013;5587;191;59;8;53;5898
AT31;41101;Allerheiligen im Mühlkreis;2013;1178;6;2;0;7;1193
AT31;41102;Arbing;2013;1314;31;12;7;9;1373
AT31;41103;Baumgartenberg;2013;1572;56;5;2;39;1674
AT31;41104;Dimbach;2013;997;8;0;0;9;1014
AT31;41105;Grein;2013;2768;93;22;1;76;2960
AT31;41106;Katsdorf;2013;2807;76;0;0;11;2894
AT31;41107;Klam;2013;879;17;2;1;1;900
AT31;41108;Bad Kreuzen;2013;2156;23;16;0;148;2343
AT31;41109;Langenstein;2013;2245;71;21;42;74;2453
AT31;41110;Luftenberg an der Donau;2013;3822;83;39;13;23;3980
AT31;41111;Mauthausen;2013;4330;232;102;210;39;4913
AT31;41112;Mitterkirchen im Machland;2013;1645;30;2;11;2;1690
AT31;41113;Münzbach;2013;1582;94;14;6;1;1697
AT31;41114;Naarn im Machlande;2013;3384;91;46;64;7;3592
AT31;41115;Pabneukirchen;2013;1696;20;13;0;0;1729
AT31;41116;Perg;2013;7115;281;264;267;82;8009
AT31;41117;Rechberg;2013;923;13;2;0;1;939
AT31;41118;Ried in der Riedmark;2013;4024;50;5;21;13;4113
AT31;41119;St. Georgen am Walde;2013;2033;12;0;0;32;2077
AT31;41120;St. Georgen an der Gusen;2013;3605;66;19;33;16;3739
AT31;41121;St. Nikola an der Donau;2013;643;46;6;7;128;830
AT31;41122;St. Thomas am Blasenstein;2013;901;8;4;0;4;917
AT31;41123;Saxen;2013;1672;57;10;13;6;1758
AT31;41124;Schwertberg;2013;4758;206;62;130;31;5187
AT31;41125;Waldhausen im Strudengau;2013;2743;41;18;0;58;2860
AT31;41126;Windhaag bei Perg;2013;1358;36;33;5;3;1435
AT31;41201;Andrichsfurt;2013;717;6;0;0;1;724
AT31;41202;Antiesenhofen;2013;946;72;38;6;2;1064
AT31;41203;Aurolzmünster;2013;2696;69;42;59;14;2880
AT31;41204;Eberschwang;2013;3177;84;59;11;10;3341
AT31;41205;Eitzing;2013;721;10;1;7;1;740
AT31;41206;Geiersberg;2013;519;6;4;0;0;529
AT31;41207;Geinberg;2013;1313;57;16;9;10;1405
AT31;41208;Gurten;2013;1086;39;25;18;6;1174
AT31;41209;Hohenzell;2013;2016;53;19;3;2;2093
AT31;41210;Kirchdorf am Inn;2013;573;37;0;0;2;612
AT31;41211;Kirchheim im Innkreis;2013;689;20;2;0;7;718
AT31;41212;Lambrechten;2013;1247;20;4;0;2;1273
AT31;41213;Lohnsburg am Kobernaußerwald;2013;2111;52;0;2;6;2171
AT31;41214;Mehrnbach;2013;2174;61;23;10;10;2278
AT31;41215;Mettmach;2013;2358;48;2;4;2;2414
AT31;41216;Mörschwang;2013;304;11;0;0;7;322
AT31;41217;Mühlheim am Inn;2013;609;36;0;1;4;650
AT31;41218;Neuhofen im Innkreis;2013;2114;77;22;5;8;2226
AT31;41219;Obernberg am Inn;2013;1270;146;30;7;17;1470
AT31;41220;Ort im Innkreis;2013;1120;65;28;18;1;1232
AT31;41221;Pattigham;2013;861;12;5;0;2;880
AT31;41222;Peterskirchen;2013;652;8;0;1;0;661
AT31;41223;Pramet;2013;949;36;16;0;0;1001
AT31;41224;Reichersberg;2013;1314;121;13;11;32;1491
AT31;41225;Ried im Innkreis;2013;9719;587;498;483;157;11444
AT31;41226;St. Georgen bei Obernberg am Inn;2013;533;28;5;0;1;567
AT31;41227;St. Marienkirchen am Hausruck;2013;825;11;6;0;3;845
AT31;41228;St. Martin im Innkreis;2013;1533;195;65;6;17;1816
AT31;41229;Schildorn;2013;1127;25;0;0;2;1154
AT31;41230;Senftenbach;2013;703;35;1;9;3;751
AT31;41231;Taiskirchen im Innkreis;2013;2377;47;1;3;5;2433
AT31;41232;Tumeltsham;2013;1461;26;36;12;2;1537
AT31;41233;Utzenaich;2013;1457;50;22;2;2;1533
AT31;41234;Waldzell;2013;2074;45;1;4;3;2127
AT31;41235;Weilbach;2013;579;28;0;0;1;608
AT31;41236;Wippenham;2013;528;15;4;2;1;550
AT31;41304;Altenfelden;2013;2068;12;1;18;12;2111
AT31;41305;Arnreit;2013;1122;4;8;0;5;1139
AT31;41306;Atzesberg;2013;442;9;0;0;0;451
AT31;41307;Auberg;2013;547;5;0;0;5;557
AT31;41309;Haslach an der Mühl;2013;2423;48;7;13;13;2504
AT31;41311;Hörbich;2013;412;4;1;0;0;417
AT31;41312;Hofkirchen im Mühlkreis;2013;1427;43;0;0;6;1476
AT31;41313;Julbach;2013;1524;29;0;0;4;1557
AT31;41314;Kirchberg ob der Donau;2013;1030;21;0;0;1;1052
AT31;41315;Klaffer am Hochficht;2013;1235;54;1;6;2;1298
AT31;41316;Kleinzell im Mühlkreis;2013;1464;14;0;12;5;1495
AT31;41317;Kollerschlag;2013;1436;41;0;1;3;1481
AT31;41318;Lembach im Mühlkreis;2013;1481;23;25;1;26;1556
AT31;41319;Lichtenau im Mühlkreis;2013;509;9;0;0;3;521
AT31;41320;Nebelberg;2013;606;13;0;0;0;619
AT31;41321;Neufelden;2013;1160;18;45;0;75;1298
AT31;41322;Niederkappel;2013;971;8;0;0;2;981
AT31;41323;Niederwaldkirchen;2013;1728;22;0;4;8;1762
AT31;41324;Oberkappel;2013;661;36;0;5;49;751
AT31;41325;Oepping;2013;1496;6;5;0;1;1508
AT31;41326;Peilstein im Mühlviertel;2013;1534;25;0;0;1;1560
AT31;41327;Pfarrkirchen im Mühlkreis;2013;1411;48;0;0;22;1481
AT31;41328;Putzleinsdorf;2013;1482;33;18;0;8;1541
AT31;41329;Neustift im Mühlkreis;2013;1391;46;0;0;8;1445
AT31;41331;St. Johann am Wimberg;2013;998;17;0;2;4;1021
AT31;41332;St. Martin im Mühlkreis;2013;3536;57;5;38;9;3645
AT31;41333;St. Oswald bei Haslach;2013;488;8;0;0;0;496
AT31;41334;St. Peter am Wimberg;2013;1722;18;0;2;1;1743
AT31;41336;St. Ulrich im Mühlkreis;2013;646;5;0;3;3;657
AT31;41337;St. Veit im Mühlkreis;2013;1189;13;2;0;8;1212
AT31;41338;Sarleinsbach;2013;2229;24;0;0;9;2262
AT31;41341;Schwarzenberg am Böhmerwald;2013;552;68;2;0;5;627
AT31;41342;Ulrichsberg;2013;2778;91;1;0;14;2884
AT31;41343;Aigen-Schlägl;2013;3027;64;21;3;23;3138
AT31;41344;Rohrbach-Berg;2013;4783;139;65;19;42;5048
AT31;41345;Helfenberg;2013;1466;25;4;22;6;1523
AT31;41346;St. Stefan-Afiesl;2013;1083;21;0;0;3;1107
AT31;41401;Altschwendt;2013;649;8;0;2;4;663
AT31;41402;Andorf;2013;4845;119;51;79;29;5123
AT31;41403;Brunnenthal;2013;1808;135;12;16;7;1978
AT31;41404;Diersbach;2013;1515;41;1;1;4;1562
AT31;41405;Dorf an der Pram;2013;1020;17;3;2;0;1042
AT31;41406;Eggerding;2013;1240;22;0;0;6;1268
AT31;41407;Engelhartszell;2013;878;56;4;0;33;971
AT31;41408;Enzenkirchen;2013;1699;51;0;0;8;1758
AT31;41409;Esternberg;2013;2735;129;1;1;4;2870
AT31;41410;Freinberg;2013;1135;309;8;0;5;1457
AT31;41411;Kopfing im Innkreis;2013;1887;52;1;0;11;1951
AT31;41412;Mayrhof;2013;295;5;0;0;1;301
AT31;41413;Münzkirchen;2013;2473;54;8;0;10;2545
AT31;41414;Raab;2013;2157;62;7;32;2;2260
AT31;41415;Rainbach im Innkreis;2013;1435;32;0;8;6;1481
AT31;41416;Riedau;2013;1836;54;20;67;8;1985
AT31;41417;St. Aegidi;2013;1531;39;3;0;6;1579
AT31;41418;St. Florian am Inn;2013;2833;147;12;73;6;3071
AT31;41419;St. Marienkirchen bei Schärding;2013;1738;52;0;35;10;1835
AT31;41420;St. Roman;2013;1708;23;0;0;0;1731
AT31;41421;St. Willibald;2013;1083;31;0;0;1;1115
AT31;41422;Schärding;2013;4212;315;130;153;64;4874
AT31;41423;Schardenberg;2013;2042;266;6;0;17;2331
AT31;41424;Sigharting;2013;773;23;0;2;2;800
AT31;41425;Suben;2013;1200;118;31;26;44;1419
AT31;41426;Taufkirchen an der Pram;2013;2740;78;3;62;9;2892
AT31;41427;Vichtenstein;2013;563;88;6;0;28;685
AT31;41428;Waldkirchen am Wesen;2013;1172;34;1;0;5;1212
AT31;41429;Wernstein am Inn;2013;1398;117;4;0;5;1524
AT31;41430;Zell an der Pram;2013;1890;56;14;35;9;2004
AT31;41501;Adlwang;2013;1653;41;8;2;4;1708
AT31;41502;Aschach an der Steyr;2013;2146;22;0;0;7;2175
AT31;41503;Bad Hall;2013;4471;212;82;78;31;4874
AT31;41504;Dietach;2013;2842;102;67;7;11;3029
AT31;41505;Gaflenz;2013;1816;46;6;0;3;1871
AT31;41506;Garsten;2013;6311;142;63;29;75;6620
AT31;41507;Großraming;2013;2651;27;3;0;4;2685
AT31;41508;Laussa;2013;1252;11;0;0;1;1264
AT31;41509;Losenstein;2013;1562;41;4;0;6;1613
AT31;41510;Maria Neustift;2013;1587;6;0;0;2;1595
AT31;41511;Pfarrkirchen bei Bad Hall;2013;2084;44;12;7;9;2156
AT31;41512;Reichraming;2013;1702;22;3;0;3;1730
AT31;41513;Rohr im Kremstal;2013;1164;26;7;1;6;1204
AT31;41514;St. Ulrich bei Steyr;2013;2937;42;6;7;16;3008
AT31;41515;Schiedlberg;2013;1179;32;0;2;8;1221
AT31;41516;Sierning;2013;8503;242;171;72;83;9071
AT31;41517;Ternberg;2013;3281;60;0;2;15;3358
AT31;41518;Waldneukirchen;2013;2171;37;14;25;6;2253
AT31;41521;Wolfern;2013;2950;57;1;2;10;3020
AT31;41522;Weyer;2013;4028;78;28;4;25;4163
AT31;41601;Alberndorf in der Riedmark;2013;3839;61;7;1;12;3920
AT31;41602;Altenberg bei Linz;2013;4277;85;5;0;19;4386
AT31;41603;Bad Leonfelden;2013;3915;116;35;21;29;4116
AT31;41604;Eidenberg;2013;2015;44;1;0;9;2069
AT31;41605;Engerwitzdorf;2013;8329;152;18;2;41;8542
AT31;41606;Feldkirchen an der Donau;2013;5098;72;57;8;15;5250
AT31;41607;Gallneukirchen;2013;5929;160;60;10;35;6194
AT31;41608;Goldwörth;2013;899;6;2;0;6;913
AT31;41609;Gramastetten;2013;4729;112;4;5;27;4877
AT31;41610;Haibach im Mühlkreis;2013;845;22;0;0;1;868
AT31;41611;Hellmonsödt;2013;2116;49;9;6;14;2194
AT31;41612;Herzogsdorf;2013;2403;18;0;0;13;2434
AT31;41613;Kirchschlag bei Linz;2013;1941;82;2;0;19;2044
AT31;41614;Lichtenberg;2013;2575;39;0;1;11;2626
AT31;41615;Oberneukirchen;2013;3081;45;12;3;4;3145
AT31;41616;Ottenschlag im Mühlkreis;2013;507;6;0;0;1;514
AT31;41617;Ottensheim;2013;4204;143;34;7;81;4469
AT31;41618;Puchenau;2013;4256;130;9;3;32;4430
AT31;41619;Reichenau im Mühlkreis;2013;1224;25;2;0;7;1258
AT31;41620;Reichenthal;2013;1453;23;2;0;33;1511
AT31;41621;St. Gotthard im Mühlkreis;2013;1235;31;0;0;6;1272
AT31;41622;Schenkenfelden;2013;1541;25;5;0;2;1573
AT31;41623;Sonnberg im Mühlkreis;2013;894;2;0;0;2;898
AT31;41624;Steyregg;2013;4581;174;28;5;34;4822
AT31;41626;Walding;2013;3831;67;22;6;67;3993
AT31;41627;Zwettl an der Rodl;2013;1685;31;0;8;16;1740
AT31;41628;Vorderweißenbach;2013;2534;38;3;4;3;2582
AT31;41701;Ampflwang im Hausruckwald;2013;3138;127;39;16;88;3408
AT31;41702;Attersee am Attersee;2013;1485;69;4;0;32;1590
AT31;41703;Attnang-Puchheim;2013;7040;697;608;273;188;8806
AT31;41704;Atzbach;2013;1133;26;2;0;2;1163
AT31;41705;Aurach am Hongar;2013;1581;40;6;4;6;1637
AT31;41706;Berg im Attergau;2013;963;26;4;0;5;998
AT31;41707;Desselbrunn;2013;1703;33;17;0;6;1759
AT31;41708;Fornach;2013;926;23;0;0;0;949
AT31;41709;Frankenburg am Hausruck;2013;4608;127;59;10;14;4818
AT31;41710;Frankenmarkt;2013;3308;160;71;44;27;3610
AT31;41711;Gampern;2013;2664;66;9;0;12;2751
AT31;41712;Innerschwand am Mondsee;2013;1052;51;3;0;7;1113
AT31;41713;Lenzing;2013;4585;179;132;19;99;5014
AT31;41714;Manning;2013;808;13;0;0;1;822
AT31;41715;Mondsee;2013;2800;348;182;11;65;3406
AT31;41716;Neukirchen an der Vöckla;2013;2470;53;11;1;5;2540
AT31;41717;Niederthalheim;2013;1002;17;0;11;3;1033
AT31;41718;Nußdorf am Attersee;2013;1032;69;17;1;12;1131
AT31;41719;Oberhofen am Irrsee;2013;1435;83;5;1;12;1536
AT31;41720;Oberndorf bei Schwanenstadt;2013;1349;25;24;4;4;1406
AT31;41721;Oberwang;2013;1581;35;4;2;5;1627
AT31;41722;Ottnang am Hausruck;2013;3672;168;11;8;11;3870
AT31;41723;Pfaffing;2013;1407;30;0;0;4;1441
AT31;41724;Pilsbach;2013;603;10;0;0;2;615
AT31;41725;Pitzenberg;2013;495;4;0;0;1;500
AT31;41726;Pöndorf;2013;2199;76;2;11;7;2295
AT31;41727;Puchkirchen am Trattberg;2013;952;29;7;0;1;989
AT31;41728;Pühret;2013;592;6;0;0;0;598
AT31;41729;Redleiten;2013;487;12;0;1;0;500
AT31;41730;Redlham;2013;1400;53;31;2;16;1502
AT31;41731;Regau;2013;5911;301;147;13;36;6408
AT31;41732;Rüstorf;2013;1874;57;44;8;10;1993
AT31;41733;Rutzenham;2013;255;6;4;0;0;265
AT31;41734;St. Georgen im Attergau;2013;3671;195;178;34;177;4255
AT31;41735;St. Lorenz;2013;2232;160;14;10;19;2435
AT31;41736;Schlatt;2013;1241;39;15;11;6;1312
AT31;41737;Schörfling am Attersee;2013;3039;160;28;1;19;3247
AT31;41738;Schwanenstadt;2013;3438;222;255;89;49;4053
AT31;41739;Seewalchen am Attersee;2013;5045;196;66;3;31;5341
AT31;41740;Steinbach am Attersee;2013;778;60;5;0;8;851
AT31;41741;Straß im Attergau;2013;1337;58;22;4;43;1464
AT31;41742;Tiefgraben;2013;3487;234;32;3;29;3785
AT31;41743;Timelkam;2013;5308;187;222;23;210;5950
AT31;41744;Ungenach;2013;1392;16;1;0;11;1420
AT31;41745;Unterach am Attersee;2013;1275;110;42;3;15;1445
AT31;41746;Vöcklabruck;2013;10276;667;506;83;413;11945
AT31;41747;Vöcklamarkt;2013;4348;175;125;46;38;4732
AT31;41748;Weißenkirchen im Attergau;2013;897;31;0;0;0;928
AT31;41749;Weyregg am Attersee;2013;1437;47;3;0;3;1490
AT31;41750;Wolfsegg am Hausruck;2013;1865;131;0;1;46;2043
AT31;41751;Zell am Moos;2013;1409;63;18;13;49;1552
AT31;41752;Zell am Pettenfirst;2013;1092;40;4;0;20;1156
AT31;41801;Aichkirchen;2013;540;11;10;3;1;565
AT31;41802;Bachmanning;2013;617;46;4;12;1;680
AT31;41803;Bad Wimsbach-Neydharting;2013;2339;53;26;20;9;2447
AT31;41804;Buchkirchen;2013;3899;91;17;13;15;4035
AT31;41805;Eberstalzell;2013;2270;49;48;4;9;2380
AT31;41806;Edt bei Lambach;2013;1892;74;45;12;7;2030
AT31;41807;Fischlham;2013;1296;18;0;2;5;1321
AT31;41808;Gunskirchen;2013;5334;272;74;13;11;5704
AT31;41809;Holzhausen;2013;744;52;0;1;4;801
AT31;41810;Krenglbach;2013;2883;62;27;6;16;2994
AT31;41811;Lambach;2013;2820;195;232;42;62;3351
AT31;41812;Marchtrenk;2013;11165;853;295;215;90;12618
AT31;41813;Neukirchen bei Lambach;2013;865;14;2;3;4;888
AT31;41814;Offenhausen;2013;1483;56;11;21;6;1577
AT31;41815;Pennewang;2013;883;16;1;0;0;900
AT31;41816;Pichl bei Wels;2013;2607;98;35;40;16;2796
AT31;41817;Sattledt;2013;2218;100;53;57;19;2447
AT31;41818;Schleißheim;2013;1222;50;3;1;10;1286
AT31;41819;Sipbachzell;2013;1805;52;13;10;9;1889
AT31;41820;Stadl-Paura;2013;4149;269;312;62;111;4903
AT31;41821;Steinerkirchen an der Traun;2013;2265;64;15;2;9;2355
AT31;41822;Steinhaus;2013;1864;57;7;1;8;1937
AT31;41823;Thalheim bei Wels;2013;4949;287;117;55;48;5456
AT31;41824;Weißkirchen an der Traun;2013;3026;102;25;32;55;3240
AT31;40101;Linz;2012;160138;10779;9734;3143;7707;191501
AT31;40201;Steyr;2012;32636;1602;2297;848;757;38140
AT31;40301;Wels;2012;47566;3722;4586;1542;1466;58882
AT31;40401;Altheim;2012;4348;214;150;14;10;4736
AT31;40402;Aspach;2012;2341;101;11;1;5;2459
AT31;40403;Auerbach;2012;485;29;6;0;7;527
AT31;40404;Braunau am Inn;2012;13614;1061;930;147;522;16274
AT31;40405;Burgkirchen;2012;2373;113;43;0;9;2538
AT31;40406;Eggelsberg;2012;2131;122;34;1;14;2302
AT31;40407;Feldkirchen bei Mattighofen;2012;1825;43;10;0;8;1886
AT31;40408;Franking;2012;862;65;16;0;3;946
AT31;40409;Geretsberg;2012;999;48;5;0;48;1100
AT31;40410;Gilgenberg am Weilhart;2012;1186;71;6;0;9;1272
AT31;40411;Haigermoos;2012;548;22;0;0;2;572
AT31;40412;Handenberg;2012;1246;47;8;0;4;1305
AT31;40413;Helpfau-Uttendorf;2012;2855;198;220;16;28;3317
AT31;40414;Hochburg-Ach;2012;2504;571;11;1;17;3104
AT31;40415;Höhnhart;2012;1344;32;0;0;3;1379
AT31;40416;Jeging;2012;633;15;13;17;2;680
AT31;40417;Kirchberg bei Mattighofen;2012;1089;33;1;12;7;1142
AT31;40418;Lengau;2012;4108;125;107;36;11;4387
AT31;40419;Lochen am See;2012;2449;73;6;2;10;2540
AT31;40420;Maria Schmolln;2012;1325;34;0;0;4;1363
AT31;40421;Mattighofen;2012;4398;364;862;104;71;5799
AT31;40422;Mauerkirchen;2012;1882;175;223;0;12;2292
AT31;40423;Mining;2012;1104;48;8;0;7;1167
AT31;40424;Moosbach;2012;886;29;1;0;4;920
AT31;40425;Moosdorf;2012;1469;69;6;5;5;1554
AT31;40426;Munderfing;2012;2574;112;107;10;10;2813
AT31;40427;Neukirchen an der Enknach;2012;2019;63;21;2;12;2117
AT31;40428;Ostermiething;2012;2838;243;76;9;24;3190
AT31;40429;Palting;2012;874;20;8;0;3;905
AT31;40430;Perwang am Grabensee;2012;873;44;0;0;1;918
AT31;40431;Pfaffstätt;2012;872;77;28;7;9;993
AT31;40432;Pischelsdorf am Engelbach;2012;1551;90;4;3;8;1656
AT31;40433;Polling im Innkreis;2012;900;29;24;0;6;959
AT31;40434;Roßbach;2012;928;24;0;0;1;953
AT31;40435;St. Georgen am Fillmannsbach;2012;378;8;1;0;1;388
AT31;40436;St. Johann am Walde;2012;1977;56;2;1;5;2041
AT31;40437;St. Pantaleon;2012;2728;198;114;6;30;3076
AT31;40438;St. Peter am Hart;2012;2139;198;19;13;57;2426
AT31;40439;St. Radegund;2012;540;34;2;0;0;576
AT31;40440;St. Veit im Innkreis;2012;397;13;0;1;1;412
AT31;40441;Schalchen;2012;3326;166;208;2;20;3722
AT31;40442;Schwand im Innkreis;2012;846;23;0;0;3;872
AT31;40443;Tarsdorf;2012;1884;105;5;0;7;2001
AT31;40444;Treubach;2012;675;30;2;0;5;712
AT31;40445;Überackern;2012;500;157;0;0;2;659
AT31;40446;Weng im Innkreis;2012;1313;58;3;0;9;1383
AT31;40501;Alkoven;2012;5092;140;93;23;25;5373
AT31;40502;Aschach an der Donau;2012;1952;57;161;5;13;2188
AT31;40503;Eferding;2012;3354;105;361;17;24;3861
AT31;40504;Fraham;2012;2154;44;48;0;5;2251
AT31;40505;Haibach ob der Donau;2012;1275;12;1;0;2;1290
AT31;40506;Hartkirchen;2012;3952;36;87;6;13;4094
AT31;40507;Hinzenbach;2012;1902;18;72;5;1;1998
AT31;40508;Prambachkirchen;2012;2718;58;22;4;6;2808
AT31;40509;Pupping;2012;1884;22;14;1;5;1926
AT31;40510;St. Marienkirchen an der Polsenz;2012;2188;27;18;18;4;2255
AT31;40511;Scharten;2012;2050;32;45;7;50;2184
AT31;40512;Stroheim;2012;1536;17;0;0;5;1558
AT31;40601;Freistadt;2012;7000;142;41;184;90;7457
AT31;40602;Grünbach;2012;1850;26;0;0;7;1883
AT31;40603;Gutau;2012;2648;27;12;0;34;2721
AT31;40604;Hagenberg im Mühlkreis;2012;2578;53;0;0;21;2652
AT31;40605;Hirschbach im Mühlkreis;2012;1120;10;1;0;3;1134
AT31;40606;Kaltenberg;2012;614;2;0;0;0;616
AT31;40607;Kefermarkt;2012;1984;38;2;0;10;2034
AT31;40608;Königswiesen;2012;3156;15;1;0;3;3175
AT31;40609;Lasberg;2012;2722;28;4;13;7;2774
AT31;40610;Leopoldschlag;2012;991;17;2;27;1;1038
AT31;40611;Liebenau;2012;1668;8;1;0;1;1678
AT31;40612;Neumarkt im Mühlkreis;2012;3060;42;1;0;19;3122
AT31;40613;Pierbach;2012;978;12;0;9;9;1008
AT31;40614;Pregarten;2012;4930;91;36;13;20;5090
AT31;40615;Rainbach im Mühlkreis;2012;2816;49;1;32;6;2904
AT31;40616;Sandl;2012;1430;15;1;1;4;1451
AT31;40617;St. Leonhard bei Freistadt;2012;1403;16;0;0;2;1421
AT31;40618;St. Oswald bei Freistadt;2012;2739;28;6;1;6;2780
AT31;40619;Schönau im Mühlkreis;2012;1886;11;1;0;1;1899
AT31;40620;Tragwein;2012;3029;41;10;2;14;3096
AT31;40621;Unterweißenbach;2012;2280;12;0;0;4;2296
AT31;40622;Unterweitersdorf;2012;1974;17;4;0;13;2008
AT31;40623;Waldburg;2012;1335;16;0;6;1;1358
AT31;40624;Wartberg ob der Aist;2012;4022;55;3;2;10;4092
AT31;40625;Weitersfelden;2012;1019;28;1;0;2;1050
AT31;40626;Windhaag bei Freistadt;2012;1567;8;1;32;22;1630
AT31;40627;Bad Zell;2012;2684;20;18;1;58;2781
AT31;40701;Altmünster;2012;9034;322;99;14;84;9553
AT31;40702;Bad Goisern am Hallstättersee;2012;7157;308;28;12;42;7547
AT31;40703;Bad Ischl;2012;12376;817;177;209;155;13734
AT31;40704;Ebensee am Traunsee;2012;7360;260;106;8;29;7763
AT31;40705;Gmunden;2012;11427;689;605;103;191;13015
AT31;40706;Gosau;2012;1671;74;8;0;9;1762
AT31;40707;Grünau im Almtal;2012;1929;81;13;23;37;2083
AT31;40708;Gschwandt;2012;2628;52;16;1;9;2706
AT31;40709;Hallstatt;2012;727;51;9;0;8;795
AT31;40710;Kirchham;2012;1915;34;0;16;7;1972
AT31;40711;Laakirchen;2012;8541;243;642;64;59;9549
AT31;40712;Obertraun;2012;663;39;0;0;30;732
AT31;40713;Ohlsdorf;2012;4670;145;106;8;13;4942
AT31;40714;Pinsdorf;2012;3396;136;129;7;19;3687
AT31;40715;Roitham am Traunfall;2012;1918;33;10;10;4;1975
AT31;40716;St. Konrad;2012;1072;24;0;0;1;1097
AT31;40717;St. Wolfgang im Salzkammergut;2012;2603;127;70;5;20;2825
AT31;40718;Traunkirchen;2012;1522;68;19;7;12;1628
AT31;40719;Scharnstein;2012;4424;192;62;24;13;4715
AT31;40720;Vorchdorf;2012;6791;138;153;146;12;7240
AT31;40801;Aistersheim;2012;808;37;5;0;9;859
AT31;40802;Bad Schallerbach;2012;3309;146;105;19;20;3599
AT31;40804;Eschenau im Hausruckkreis;2012;1050;10;0;0;7;1067
AT31;40805;Gallspach;2012;2209;204;137;56;47;2653
AT31;40806;Gaspoltshofen;2012;3320;118;38;17;10;3503
AT31;40807;Geboltskirchen;2012;1368;36;5;3;11;1423
AT31;40808;Grieskirchen;2012;4177;213;128;270;32;4820
AT31;40809;Haag am Hausruck;2012;1971;60;63;6;32;2132
AT31;40810;Heiligenberg;2012;665;9;0;0;0;674
AT31;40811;Hofkirchen an der Trattnach;2012;1479;63;45;1;3;1591
AT31;40812;Kallham;2012;2430;49;24;15;1;2519
AT31;40813;Kematen am Innbach;2012;1261;42;6;31;4;1344
AT31;40814;Meggenhofen;2012;1357;35;0;1;5;1398
AT31;40815;Michaelnbach;2012;1258;11;0;5;4;1278
AT31;40816;Natternbach;2012;2297;43;0;2;13;2355
AT31;40817;Neukirchen am Walde;2012;1592;20;11;0;6;1629
AT31;40818;Neumarkt im Hausruckkreis;2012;1301;39;20;86;4;1450
AT31;40820;Pötting;2012;534;4;0;1;0;539
AT31;40821;Pollham;2012;958;8;0;0;8;974
AT31;40822;Pram;2012;1710;31;9;0;4;1754
AT31;40823;Rottenbach;2012;1032;31;14;0;5;1082
AT31;40824;St. Agatha;2012;2096;20;0;0;2;2118
AT31;40825;St. Georgen bei Grieskirchen;2012;1192;30;2;0;1;1225
AT31;40826;St. Thomas;2012;509;5;0;0;0;514
AT31;40827;Schlüßlberg;2012;2830;63;28;20;10;2951
AT31;40828;Steegen;2012;1028;8;0;0;1;1037
AT31;40829;Taufkirchen an der Trattnach;2012;1931;27;6;8;4;1976
AT31;40830;Tollet;2012;882;17;0;0;1;900
AT31;40831;Waizenkirchen;2012;3439;77;74;26;9;3625
AT31;40832;Wallern an der Trattnach;2012;2732;89;26;24;16;2887
AT31;40833;Weibern;2012;1547;16;60;8;1;1632
AT31;40834;Wendling;2012;787;7;0;5;2;801
AT31;40835;Peuerbach;2012;4269;74;41;53;13;4450
AT31;40901;Edlbach;2012;628;24;4;0;0;656
AT31;40902;Grünburg;2012;3497;86;74;145;16;3818
AT31;40903;Hinterstoder;2012;841;66;12;0;4;923
AT31;40904;Inzersdorf im Kremstal;2012;1841;49;23;3;7;1923
AT31;40905;Kirchdorf an der Krems;2012;3693;192;177;25;39;4126
AT31;40906;Klaus an der Pyhrnbahn;2012;1010;57;12;0;8;1087
AT31;40907;Kremsmünster;2012;5719;410;246;12;32;6419
AT31;40908;Micheldorf in Oberösterreich;2012;5389;175;139;95;34;5832
AT31;40909;Molln;2012;3279;77;93;113;14;3576
AT31;40910;Nußbach;2012;2155;46;3;4;3;2211
AT31;40911;Oberschlierbach;2012;453;10;1;1;1;466
AT31;40912;Pettenbach;2012;4698;133;60;103;14;5008
AT31;40913;Ried im Traunkreis;2012;2572;61;17;16;8;2674
AT31;40914;Rosenau am Hengstpaß;2012;640;22;30;1;0;693
AT31;40915;Roßleithen;2012;1795;60;25;0;2;1882
AT31;40916;St. Pankraz;2012;314;15;8;0;0;337
AT31;40917;Schlierbach;2012;2636;88;27;7;17;2775
AT31;40918;Spital am Pyhrn;2012;2082;58;29;1;11;2181
AT31;40919;Steinbach am Ziehberg;2012;811;14;2;0;1;828
AT31;40920;Steinbach an der Steyr;2012;1956;26;5;16;5;2008
AT31;40921;Vorderstoder;2012;742;28;0;0;9;779
AT31;40922;Wartberg an der Krems;2012;2762;90;41;27;12;2932
AT31;40923;Windischgarsten;2012;2143;119;112;1;9;2384
AT31;41001;Allhaming;2012;1056;17;2;11;4;1090
AT31;41002;Ansfelden;2012;13009;872;797;467;571;15716
AT31;41003;Asten;2012;5616;291;164;85;84;6240
AT31;41004;Eggendorf im Traunkreis;2012;757;39;0;3;0;799
AT31;41005;Enns;2012;9635;563;800;232;193;11423
AT31;41006;Hargelsberg;2012;1277;33;2;0;2;1314
AT31;41007;Hörsching;2012;5330;293;93;82;49;5847
AT31;41008;Hofkirchen im Traunkreis;2012;1689;62;2;1;6;1760
AT31;41009;Kematen an der Krems;2012;2343;99;43;21;12;2518
AT31;41010;Kirchberg-Thening;2012;2228;39;10;2;8;2287
AT31;41011;Kronstorf;2012;2983;99;74;14;22;3192
AT31;41012;Leonding;2012;23340;1342;614;270;487;26053
AT31;41013;St. Florian;2012;5829;130;33;6;26;6024
AT31;41014;Neuhofen an der Krems;2012;5314;170;146;32;43;5705
AT31;41015;Niederneukirchen;2012;1886;26;14;0;9;1935
AT31;41016;Oftering;2012;1877;50;25;3;7;1962
AT31;41017;Pasching;2012;5962;334;190;95;74;6655
AT31;41018;Piberbach;2012;1774;50;7;1;12;1844
AT31;41019;Pucking;2012;3644;87;40;22;9;3802
AT31;41020;St. Marien;2012;4418;93;26;35;16;4588
AT31;41021;Traun;2012;19289;1366;1667;595;707;23624
AT31;41022;Wilhering;2012;5497;178;56;13;47;5791
AT31;41101;Allerheiligen im Mühlkreis;2012;1168;5;2;0;5;1180
AT31;41102;Arbing;2012;1316;32;12;6;8;1374
AT31;41103;Baumgartenberg;2012;1562;45;3;3;36;1649
AT31;41104;Dimbach;2012;994;6;0;0;10;1010
AT31;41105;Grein;2012;2817;93;18;0;77;3005
AT31;41106;Katsdorf;2012;2783;77;0;0;9;2869
AT31;41107;Klam;2012;884;11;1;1;1;898
AT31;41108;Bad Kreuzen;2012;2173;23;8;0;134;2338
AT31;41109;Langenstein;2012;2288;44;24;43;61;2460
AT31;41110;Luftenberg an der Donau;2012;3721;66;35;12;22;3856
AT31;41111;Mauthausen;2012;4329;201;95;212;42;4879
AT31;41112;Mitterkirchen im Machland;2012;1649;26;0;11;2;1688
AT31;41113;Münzbach;2012;1597;89;24;5;2;1717
AT31;41114;Naarn im Machlande;2012;3382;87;40;64;6;3579
AT31;41115;Pabneukirchen;2012;1684;13;13;0;2;1712
AT31;41116;Perg;2012;7176;252;254;275;63;8020
AT31;41117;Rechberg;2012;919;15;2;0;1;937
AT31;41118;Ried in der Riedmark;2012;4014;44;6;26;10;4100
AT31;41119;St. Georgen am Walde;2012;2036;18;0;0;24;2078
AT31;41120;St. Georgen an der Gusen;2012;3579;62;25;38;15;3719
AT31;41121;St. Nikola an der Donau;2012;641;45;6;5;81;778
AT31;41122;St. Thomas am Blasenstein;2012;911;9;6;0;4;930
AT31;41123;Saxen;2012;1657;44;12;13;7;1733
AT31;41124;Schwertberg;2012;4749;155;59;125;29;5117
AT31;41125;Waldhausen im Strudengau;2012;2759;53;14;5;61;2892
AT31;41126;Windhaag bei Perg;2012;1366;31;39;6;3;1445
AT31;41201;Andrichsfurt;2012;705;6;0;0;1;712
AT31;41202;Antiesenhofen;2012;963;72;41;14;3;1093
AT31;41203;Aurolzmünster;2012;2722;53;36;62;9;2882
AT31;41204;Eberschwang;2012;3214;79;64;12;12;3381
AT31;41205;Eitzing;2012;705;14;1;6;2;728
AT31;41206;Geiersberg;2012;522;7;4;0;0;533
AT31;41207;Geinberg;2012;1334;58;8;10;8;1418
AT31;41208;Gurten;2012;1091;40;28;18;9;1186
AT31;41209;Hohenzell;2012;1996;32;18;3;3;2052
AT31;41210;Kirchdorf am Inn;2012;583;31;1;0;2;617
AT31;41211;Kirchheim im Innkreis;2012;682;12;1;0;9;704
AT31;41212;Lambrechten;2012;1251;21;6;0;2;1280
AT31;41213;Lohnsburg am Kobernaußerwald;2012;2105;55;0;3;7;2170
AT31;41214;Mehrnbach;2012;2198;59;16;5;7;2285
AT31;41215;Mettmach;2012;2359;54;5;4;1;2423
AT31;41216;Mörschwang;2012;308;9;0;0;6;323
AT31;41217;Mühlheim am Inn;2012;617;36;0;1;6;660
AT31;41218;Neuhofen im Innkreis;2012;2117;74;18;7;1;2217
AT31;41219;Obernberg am Inn;2012;1257;135;31;7;23;1453
AT31;41220;Ort im Innkreis;2012;1108;44;26;17;7;1202
AT31;41221;Pattigham;2012;874;10;3;0;2;889
AT31;41222;Peterskirchen;2012;645;8;0;1;0;654
AT31;41223;Pramet;2012;958;28;16;0;0;1002
AT31;41224;Reichersberg;2012;1337;99;11;11;32;1490
AT31;41225;Ried im Innkreis;2012;9764;506;501;477;133;11381
AT31;41226;St. Georgen bei Obernberg am Inn;2012;553;27;6;0;1;587
AT31;41227;St. Marienkirchen am Hausruck;2012;816;11;7;0;4;838
AT31;41228;St. Martin im Innkreis;2012;1517;190;66;7;12;1792
AT31;41229;Schildorn;2012;1122;19;0;0;0;1141
AT31;41230;Senftenbach;2012;701;29;1;9;7;747
AT31;41231;Taiskirchen im Innkreis;2012;2385;52;1;3;6;2447
AT31;41232;Tumeltsham;2012;1460;22;40;12;4;1538
AT31;41233;Utzenaich;2012;1455;54;22;2;2;1535
AT31;41234;Waldzell;2012;2044;40;2;4;2;2092
AT31;41235;Weilbach;2012;593;32;1;0;3;629
AT31;41236;Wippenham;2012;520;11;3;1;1;536
AT31;41304;Altenfelden;2012;2073;14;0;17;13;2117
AT31;41305;Arnreit;2012;1140;6;7;0;5;1158
AT31;41306;Atzesberg;2012;447;9;0;0;0;456
AT31;41307;Auberg;2012;563;7;0;0;5;575
AT31;41309;Haslach an der Mühl;2012;2438;47;7;12;12;2516
AT31;41311;Hörbich;2012;410;4;1;0;0;415
AT31;41312;Hofkirchen im Mühlkreis;2012;1431;42;0;0;8;1481
AT31;41313;Julbach;2012;1535;33;0;0;3;1571
AT31;41314;Kirchberg ob der Donau;2012;1039;18;0;0;1;1058
AT31;41315;Klaffer am Hochficht;2012;1250;55;1;6;2;1314
AT31;41316;Kleinzell im Mühlkreis;2012;1446;10;0;10;6;1472
AT31;41317;Kollerschlag;2012;1439;47;0;1;3;1490
AT31;41318;Lembach im Mühlkreis;2012;1471;27;23;1;18;1540
AT31;41319;Lichtenau im Mühlkreis;2012;507;7;0;0;1;515
AT31;41320;Nebelberg;2012;619;13;0;0;0;632
AT31;41321;Neufelden;2012;1162;19;47;1;58;1287
AT31;41322;Niederkappel;2012;968;4;0;0;0;972
AT31;41323;Niederwaldkirchen;2012;1716;17;0;4;7;1744
AT31;41324;Oberkappel;2012;647;34;0;4;48;733
AT31;41325;Oepping;2012;1524;6;5;0;1;1536
AT31;41326;Peilstein im Mühlviertel;2012;1534;26;0;0;1;1561
AT31;41327;Pfarrkirchen im Mühlkreis;2012;1410;44;0;0;28;1482
AT31;41328;Putzleinsdorf;2012;1480;34;18;0;6;1538
AT31;41329;Neustift im Mühlkreis;2012;1394;48;0;0;8;1450
AT31;41331;St. Johann am Wimberg;2012;990;17;0;2;4;1013
AT31;41332;St. Martin im Mühlkreis;2012;3502;35;1;39;9;3586
AT31;41333;St. Oswald bei Haslach;2012;488;8;0;0;0;496
AT31;41334;St. Peter am Wimberg;2012;1737;14;0;2;1;1754
AT31;41336;St. Ulrich im Mühlkreis;2012;662;4;1;3;3;673
AT31;41337;St. Veit im Mühlkreis;2012;1181;13;2;0;8;1204
AT31;41338;Sarleinsbach;2012;2221;20;0;0;9;2250
AT31;41341;Schwarzenberg am Böhmerwald;2012;562;62;2;0;3;629
AT31;41342;Ulrichsberg;2012;2821;67;0;1;11;2900
AT31;41343;Aigen-Schlägl;2012;3065;67;22;4;22;3180
AT31;41344;Rohrbach-Berg;2012;4777;98;66;15;41;4997
AT31;41345;Helfenberg;2012;1474;27;4;22;6;1533
AT31;41346;St. Stefan-Afiesl;2012;1097;16;0;0;3;1116
AT31;41401;Altschwendt;2012;653;9;0;2;5;669
AT31;41402;Andorf;2012;4830;97;50;76;31;5084
AT31;41403;Brunnenthal;2012;1814;119;9;16;11;1969
AT31;41404;Diersbach;2012;1549;39;3;1;5;1597
AT31;41405;Dorf an der Pram;2012;1022;18;2;2;0;1044
AT31;41406;Eggerding;2012;1236;21;0;0;5;1262
AT31;41407;Engelhartszell;2012;903;53;6;0;10;972
AT31;41408;Enzenkirchen;2012;1712;38;0;0;8;1758
AT31;41409;Esternberg;2012;2752;129;6;1;6;2894
AT31;41410;Freinberg;2012;1150;311;3;0;4;1468
AT31;41411;Kopfing im Innkreis;2012;1907;42;1;0;8;1958
AT31;41412;Mayrhof;2012;285;6;0;0;1;292
AT31;41413;Münzkirchen;2012;2483;50;6;0;10;2549
AT31;41414;Raab;2012;2163;51;8;28;2;2252
AT31;41415;Rainbach im Innkreis;2012;1464;24;0;7;7;1502
AT31;41416;Riedau;2012;1847;49;31;64;7;1998
AT31;41417;St. Aegidi;2012;1546;39;5;0;6;1596
AT31;41418;St. Florian am Inn;2012;2852;138;13;74;11;3088
AT31;41419;St. Marienkirchen bei Schärding;2012;1748;55;0;32;8;1843
AT31;41420;St. Roman;2012;1705;24;0;1;0;1730
AT31;41421;St. Willibald;2012;1082;29;0;0;1;1112
AT31;41422;Schärding;2012;4244;275;123;148;46;4836
AT31;41423;Schardenberg;2012;2044;251;6;0;11;2312
AT31;41424;Sigharting;2012;772;22;0;2;1;797
AT31;41425;Suben;2012;1222;126;42;27;53;1470
AT31;41426;Taufkirchen an der Pram;2012;2756;72;3;62;12;2905
AT31;41427;Vichtenstein;2012;557;91;6;0;21;675
AT31;41428;Waldkirchen am Wesen;2012;1185;24;1;0;4;1214
AT31;41429;Wernstein am Inn;2012;1404;127;4;0;5;1540
AT31;41430;Zell an der Pram;2012;1892;56;13;37;9;2007
AT31;41501;Adlwang;2012;1627;34;12;4;7;1684
AT31;41502;Aschach an der Steyr;2012;2139;20;0;0;5;2164
AT31;41503;Bad Hall;2012;4432;181;79;76;28;4796
AT31;41504;Dietach;2012;2855;95;64;9;9;3032
AT31;41505;Gaflenz;2012;1817;51;6;0;3;1877
AT31;41506;Garsten;2012;6340;124;57;35;53;6609
AT31;41507;Großraming;2012;2641;28;2;0;4;2675
AT31;41508;Laussa;2012;1262;9;0;0;1;1272
AT31;41509;Losenstein;2012;1577;34;3;0;7;1621
AT31;41510;Maria Neustift;2012;1604;5;0;0;3;1612
AT31;41511;Pfarrkirchen bei Bad Hall;2012;2094;39;13;6;9;2161
AT31;41512;Reichraming;2012;1739;20;2;0;3;1764
AT31;41513;Rohr im Kremstal;2012;1175;25;6;1;3;1210
AT31;41514;St. Ulrich bei Steyr;2012;2925;38;6;7;13;2989
AT31;41515;Schiedlberg;2012;1184;27;0;2;8;1221
AT31;41516;Sierning;2012;8515;211;171;66;78;9041
AT31;41517;Ternberg;2012;3253;58;3;2;14;3330
AT31;41518;Waldneukirchen;2012;2158;42;7;22;6;2235
AT31;41521;Wolfern;2012;2923;46;3;2;9;2983
AT31;41522;Weyer;2012;4084;75;29;3;22;4213
AT31;41601;Alberndorf in der Riedmark;2012;3803;61;8;1;10;3883
AT31;41602;Altenberg bei Linz;2012;4307;73;7;0;23;4410
AT31;41603;Bad Leonfelden;2012;3895;111;32;23;14;4075
AT31;41604;Eidenberg;2012;2020;34;0;0;8;2062
AT31;41605;Engerwitzdorf;2012;8343;151;14;2;42;8552
AT31;41606;Feldkirchen an der Donau;2012;5063;65;59;8;8;5203
AT31;41607;Gallneukirchen;2012;5948;141;66;11;38;6204
AT31;41608;Goldwörth;2012;901;11;2;0;6;920
AT31;41609;Gramastetten;2012;4700;98;4;5;34;4841
AT31;41610;Haibach im Mühlkreis;2012;850;26;0;0;3;879
AT31;41611;Hellmonsödt;2012;2095;45;12;6;17;2175
AT31;41612;Herzogsdorf;2012;2425;17;0;0;11;2453
AT31;41613;Kirchschlag bei Linz;2012;1943;73;1;1;19;2037
AT31;41614;Lichtenberg;2012;2542;40;1;1;11;2595
AT31;41615;Oberneukirchen;2012;3090;49;13;4;6;3162
AT31;41616;Ottenschlag im Mühlkreis;2012;505;5;0;0;1;511
AT31;41617;Ottensheim;2012;4269;120;31;8;72;4500
AT31;41618;Puchenau;2012;4299;120;10;2;40;4471
AT31;41619;Reichenau im Mühlkreis;2012;1225;17;2;3;9;1256
AT31;41620;Reichenthal;2012;1436;24;2;0;4;1466
AT31;41621;St. Gotthard im Mühlkreis;2012;1233;35;0;0;3;1271
AT31;41622;Schenkenfelden;2012;1522;12;5;0;3;1542
AT31;41623;Sonnberg im Mühlkreis;2012;883;3;0;0;2;888
AT31;41624;Steyregg;2012;4587;145;29;2;34;4797
AT31;41626;Walding;2012;3818;59;15;7;69;3968
AT31;41627;Zwettl an der Rodl;2012;1659;26;0;7;16;1708
AT31;41628;Vorderweißenbach;2012;2543;35;3;4;3;2588
AT31;41701;Ampflwang im Hausruckwald;2012;3179;113;48;10;96;3446
AT31;41702;Attersee am Attersee;2012;1477;74;4;0;33;1588
AT31;41703;Attnang-Puchheim;2012;7156;638;598;259;157;8808
AT31;41704;Atzbach;2012;1137;24;3;0;2;1166
AT31;41705;Aurach am Hongar;2012;1551;35;9;4;5;1604
AT31;41706;Berg im Attergau;2012;959;22;6;0;4;991
AT31;41707;Desselbrunn;2012;1669;31;16;0;6;1722
AT31;41708;Fornach;2012;928;28;0;0;1;957
AT31;41709;Frankenburg am Hausruck;2012;4604;118;55;9;9;4795
AT31;41710;Frankenmarkt;2012;3239;122;62;48;30;3501
AT31;41711;Gampern;2012;2633;62;12;0;9;2716
AT31;41712;Innerschwand am Mondsee;2012;1071;46;2;0;6;1125
AT31;41713;Lenzing;2012;4646;160;136;20;108;5070
AT31;41714;Manning;2012;798;8;0;0;1;807
AT31;41715;Mondsee;2012;2793;315;195;10;61;3374
AT31;41716;Neukirchen an der Vöckla;2012;2443;49;9;1;4;2506
AT31;41717;Niederthalheim;2012;998;18;0;13;4;1033
AT31;41718;Nußdorf am Attersee;2012;1014;70;20;0;14;1118
AT31;41719;Oberhofen am Irrsee;2012;1440;63;6;1;10;1520
AT31;41720;Oberndorf bei Schwanenstadt;2012;1346;28;25;5;4;1408
AT31;41721;Oberwang;2012;1569;24;7;1;5;1606
AT31;41722;Ottnang am Hausruck;2012;3716;146;12;7;10;3891
AT31;41723;Pfaffing;2012;1408;26;0;0;4;1438
AT31;41724;Pilsbach;2012;609;4;0;0;2;615
AT31;41725;Pitzenberg;2012;487;5;0;0;1;493
AT31;41726;Pöndorf;2012;2194;71;3;11;3;2282
AT31;41727;Puchkirchen am Trattberg;2012;948;21;4;0;3;976
AT31;41728;Pühret;2012;589;5;0;0;0;594
AT31;41729;Redleiten;2012;488;13;0;1;1;503
AT31;41730;Redlham;2012;1368;54;25;2;16;1465
AT31;41731;Regau;2012;5900;282;140;15;36;6373
AT31;41732;Rüstorf;2012;1883;37;40;7;8;1975
AT31;41733;Rutzenham;2012;247;7;0;0;0;254
AT31;41734;St. Georgen im Attergau;2012;3636;162;181;32;191;4202
AT31;41735;St. Lorenz;2012;2181;149;10;11;19;2370
AT31;41736;Schlatt;2012;1255;38;17;12;8;1330
AT31;41737;Schörfling am Attersee;2012;3041;143;24;1;17;3226
AT31;41738;Schwanenstadt;2012;3453;228;263;70;44;4058
AT31;41739;Seewalchen am Attersee;2012;5014;191;67;2;32;5306
AT31;41740;Steinbach am Attersee;2012;783;54;6;0;6;849
AT31;41741;Straß im Attergau;2012;1380;52;25;4;36;1497
AT31;41742;Tiefgraben;2012;3469;196;34;3;30;3732
AT31;41743;Timelkam;2012;5316;162;206;18;169;5871
AT31;41744;Ungenach;2012;1387;20;0;0;12;1419
AT31;41745;Unterach am Attersee;2012;1284;104;37;3;16;1444
AT31;41746;Vöcklabruck;2012;10376;612;489;81;396;11954
AT31;41747;Vöcklamarkt;2012;4362;173;124;50;29;4738
AT31;41748;Weißenkirchen im Attergau;2012;892;28;0;0;0;920
AT31;41749;Weyregg am Attersee;2012;1469;41;2;0;4;1516
AT31;41750;Wolfsegg am Hausruck;2012;1867;115;0;1;42;2025
AT31;41751;Zell am Moos;2012;1402;60;16;14;41;1533
AT31;41752;Zell am Pettenfirst;2012;1101;45;3;0;17;1166
AT31;41801;Aichkirchen;2012;529;8;12;3;1;553
AT31;41802;Bachmanning;2012;626;49;4;11;1;691
AT31;41803;Bad Wimsbach-Neydharting;2012;2301;53;35;23;8;2420
AT31;41804;Buchkirchen;2012;3864;78;22;17;15;3996
AT31;41805;Eberstalzell;2012;2238;43;49;5;9;2344
AT31;41806;Edt bei Lambach;2012;1888;62;38;15;9;2012
AT31;41807;Fischlham;2012;1295;19;0;2;5;1321
AT31;41808;Gunskirchen;2012;5316;272;87;11;12;5698
AT31;41809;Holzhausen;2012;754;36;0;1;4;795
AT31;41810;Krenglbach;2012;2880;58;29;6;17;2990
AT31;41811;Lambach;2012;2795;180;250;46;63;3334
AT31;41812;Marchtrenk;2012;11159;737;306;219;88;12509
AT31;41813;Neukirchen bei Lambach;2012;854;19;3;3;3;882
AT31;41814;Offenhausen;2012;1493;53;11;19;6;1582
AT31;41815;Pennewang;2012;872;16;1;0;0;889
AT31;41816;Pichl bei Wels;2012;2634;113;40;36;17;2840
AT31;41817;Sattledt;2012;2221;92;49;62;22;2446
AT31;41818;Schleißheim;2012;1192;40;3;1;8;1244
AT31;41819;Sipbachzell;2012;1792;42;11;9;11;1865
AT31;41820;Stadl-Paura;2012;4172;220;313;60;121;4886
AT31;41821;Steinerkirchen an der Traun;2012;2274;55;16;2;8;2355
AT31;41822;Steinhaus;2012;1846;55;4;1;8;1914
AT31;41823;Thalheim bei Wels;2012;4995;259;119;58;39;5470
AT31;41824;Weißkirchen an der Traun;2012;3002;97;22;29;57;3207
AT31;40101;Linz;2011;160661;9792;9387;3075;7138;190053
AT31;40201;Steyr;2011;32859;1482;2281;809;762;38193
AT31;40301;Wels;2011;47787;3443;4487;1514;1337;58568
AT31;40401;Altheim;2011;4411;191;150;14;14;4780
AT31;40402;Aspach;2011;2303;82;11;1;4;2401
AT31;40403;Auerbach;2011;483;27;7;0;7;524
AT31;40404;Braunau am Inn;2011;13739;971;915;125;429;16179
AT31;40405;Burgkirchen;2011;2381;102;43;0;18;2544
AT31;40406;Eggelsberg;2011;2121;111;34;1;10;2277
AT31;40407;Feldkirchen bei Mattighofen;2011;1841;44;11;0;5;1901
AT31;40408;Franking;2011;855;53;19;0;9;936
AT31;40409;Geretsberg;2011;987;41;5;0;41;1074
AT31;40410;Gilgenberg am Weilhart;2011;1199;75;2;0;10;1286
AT31;40411;Haigermoos;2011;563;23;0;0;2;588
AT31;40412;Handenberg;2011;1244;42;11;0;4;1301
AT31;40413;Helpfau-Uttendorf;2011;2845;210;228;18;45;3346
AT31;40414;Hochburg-Ach;2011;2536;545;13;1;12;3107
AT31;40415;Höhnhart;2011;1332;31;0;0;3;1366
AT31;40416;Jeging;2011;625;13;14;18;2;672
AT31;40417;Kirchberg bei Mattighofen;2011;1066;39;2;7;7;1121
AT31;40418;Lengau;2011;4099;123;110;38;15;4385
AT31;40419;Lochen am See;2011;2416;53;6;1;12;2488
AT31;40420;Maria Schmolln;2011;1340;31;0;0;4;1375
AT31;40421;Mattighofen;2011;4362;331;875;102;67;5737
AT31;40422;Mauerkirchen;2011;1974;84;234;0;13;2305
AT31;40423;Mining;2011;1105;45;8;0;4;1162
AT31;40424;Moosbach;2011;891;31;1;0;3;926
AT31;40425;Moosdorf;2011;1448;62;6;0;6;1522
AT31;40426;Munderfing;2011;2539;97;98;13;10;2757
AT31;40427;Neukirchen an der Enknach;2011;2019;66;19;1;10;2115
AT31;40428;Ostermiething;2011;2828;233;70;8;25;3164
AT31;40429;Palting;2011;864;16;8;6;2;896
AT31;40430;Perwang am Grabensee;2011;844;44;0;0;1;889
AT31;40431;Pfaffstätt;2011;870;91;20;7;4;992
AT31;40432;Pischelsdorf am Engelbach;2011;1572;61;2;3;7;1645
AT31;40433;Polling im Innkreis;2011;881;29;22;0;8;940
AT31;40434;Roßbach;2011;922;21;0;0;1;944
AT31;40435;St. Georgen am Fillmannsbach;2011;386;7;1;0;1;395
AT31;40436;St. Johann am Walde;2011;1980;59;1;1;7;2048
AT31;40437;St. Pantaleon;2011;2741;191;121;6;30;3089
AT31;40438;St. Peter am Hart;2011;2157;176;17;13;53;2416
AT31;40439;St. Radegund;2011;527;35;0;0;0;562
AT31;40440;St. Veit im Innkreis;2011;391;13;0;1;1;406
AT31;40441;Schalchen;2011;3345;133;204;2;18;3702
AT31;40442;Schwand im Innkreis;2011;851;22;0;0;2;875
AT31;40443;Tarsdorf;2011;1886;94;5;0;6;1991
AT31;40444;Treubach;2011;689;22;1;0;5;717
AT31;40445;Überackern;2011;490;152;0;0;2;644
AT31;40446;Weng im Innkreis;2011;1305;45;3;0;10;1363
AT31;40501;Alkoven;2011;5092;119;98;23;26;5358
AT31;40502;Aschach an der Donau;2011;1953;65;152;3;13;2186
AT31;40503;Eferding;2011;3376;102;346;17;17;3858
AT31;40504;Fraham;2011;2125;38;54;0;5;2222
AT31;40505;Haibach ob der Donau;2011;1288;13;1;0;2;1304
AT31;40506;Hartkirchen;2011;3940;28;94;4;11;4077
AT31;40507;Hinzenbach;2011;1901;20;60;5;1;1987
AT31;40508;Prambachkirchen;2011;2733;53;22;4;6;2818
AT31;40509;Pupping;2011;1887;20;12;1;4;1924
AT31;40510;St. Marienkirchen an der Polsenz;2011;2188;25;22;16;3;2254
AT31;40511;Scharten;2011;2038;31;52;7;53;2181
AT31;40512;Stroheim;2011;1522;15;0;0;4;1541
AT31;40601;Freistadt;2011;7015;142;44;172;87;7460
AT31;40602;Grünbach;2011;1850;24;0;2;7;1883
AT31;40603;Gutau;2011;2635;27;7;0;6;2675
AT31;40604;Hagenberg im Mühlkreis;2011;2577;54;0;1;12;2644
AT31;40605;Hirschbach im Mühlkreis;2011;1111;10;0;0;2;1123
AT31;40606;Kaltenberg;2011;621;2;0;0;0;623
AT31;40607;Kefermarkt;2011;2014;29;2;0;11;2056
AT31;40608;Königswiesen;2011;3171;13;1;0;3;3188
AT31;40609;Lasberg;2011;2744;28;4;10;5;2791
AT31;40610;Leopoldschlag;2011;985;15;0;27;1;1028
AT31;40611;Liebenau;2011;1697;13;1;0;1;1712
AT31;40612;Neumarkt im Mühlkreis;2011;3029;35;1;2;18;3085
AT31;40613;Pierbach;2011;985;9;1;4;7;1006
AT31;40614;Pregarten;2011;4934;77;32;17;25;5085
AT31;40615;Rainbach im Mühlkreis;2011;2829;49;0;31;7;2916
AT31;40616;Sandl;2011;1427;7;1;1;5;1441
AT31;40617;St. Leonhard bei Freistadt;2011;1407;13;0;0;2;1422
AT31;40618;St. Oswald bei Freistadt;2011;2731;25;6;3;6;2771
AT31;40619;Schönau im Mühlkreis;2011;1869;11;1;0;1;1882
AT31;40620;Tragwein;2011;3015;37;11;2;14;3079
AT31;40621;Unterweißenbach;2011;2296;11;0;0;4;2311
AT31;40622;Unterweitersdorf;2011;1961;19;4;0;15;1999
AT31;40623;Waldburg;2011;1348;18;0;7;2;1375
AT31;40624;Wartberg ob der Aist;2011;3984;52;5;2;8;4051
AT31;40625;Weitersfelden;2011;1038;22;2;0;2;1064
AT31;40626;Windhaag bei Freistadt;2011;1576;10;1;32;22;1641
AT31;40627;Bad Zell;2011;2661;20;16;1;58;2756
AT31;40701;Altmünster;2011;9027;312;92;15;41;9487
AT31;40702;Bad Goisern am Hallstättersee;2011;7152;296;29;11;42;7530
AT31;40703;Bad Ischl;2011;12537;820;175;218;133;13883
AT31;40704;Ebensee am Traunsee;2011;7442;238;110;8;27;7825
AT31;40705;Gmunden;2011;11498;626;623;103;171;13021
AT31;40706;Gosau;2011;1692;74;13;0;15;1794
AT31;40707;Grünau im Almtal;2011;1958;84;8;22;36;2108
AT31;40708;Gschwandt;2011;2604;33;18;0;8;2663
AT31;40709;Hallstatt;2011;736;42;7;0;6;791
AT31;40710;Kirchham;2011;1871;39;1;15;6;1932
AT31;40711;Laakirchen;2011;8544;220;649;71;54;9538
AT31;40712;Obertraun;2011;652;37;0;0;28;717
AT31;40713;Ohlsdorf;2011;4646;141;99;8;15;4909
AT31;40714;Pinsdorf;2011;3361;122;139;5;20;3647
AT31;40715;Roitham am Traunfall;2011;1930;31;13;7;5;1986
AT31;40716;St. Konrad;2011;1063;23;0;0;2;1088
AT31;40717;St. Wolfgang im Salzkammergut;2011;2613;135;74;4;21;2847
AT31;40718;Traunkirchen;2011;1537;53;19;8;14;1631
AT31;40719;Scharnstein;2011;4442;182;70;28;12;4734
AT31;40720;Vorchdorf;2011;6829;135;150;149;15;7278
AT31;40801;Aistersheim;2011;808;31;4;0;5;848
AT31;40802;Bad Schallerbach;2011;3272;144;104;17;18;3555
AT31;40804;Eschenau im Hausruckkreis;2011;1072;9;0;0;5;1086
AT31;40805;Gallspach;2011;2206;195;137;56;17;2611
AT31;40806;Gaspoltshofen;2011;3297;109;40;18;10;3474
AT31;40807;Geboltskirchen;2011;1384;37;5;3;10;1439
AT31;40808;Grieskirchen;2011;4209;172;123;265;35;4804
AT31;40809;Haag am Hausruck;2011;1983;42;64;6;32;2127
AT31;40810;Heiligenberg;2011;675;8;0;0;0;683
AT31;40811;Hofkirchen an der Trattnach;2011;1486;56;49;1;3;1595
AT31;40812;Kallham;2011;2449;48;19;19;4;2539
AT31;40813;Kematen am Innbach;2011;1274;43;6;26;5;1354
AT31;40814;Meggenhofen;2011;1336;33;0;1;8;1378
AT31;40815;Michaelnbach;2011;1270;8;0;5;4;1287
AT31;40816;Natternbach;2011;2270;32;0;3;13;2318
AT31;40817;Neukirchen am Walde;2011;1593;16;13;0;4;1626
AT31;40818;Neumarkt im Hausruckkreis;2011;1325;40;18;88;3;1474
AT31;40820;Pötting;2011;536;3;0;0;0;539
AT31;40821;Pollham;2011;968;9;0;0;7;984
AT31;40822;Pram;2011;1694;30;9;0;3;1736
AT31;40823;Rottenbach;2011;1049;23;15;0;3;1090
AT31;40824;St. Agatha;2011;2115;17;0;0;2;2134
AT31;40825;St. Georgen bei Grieskirchen;2011;1134;20;5;0;0;1159
AT31;40826;St. Thomas;2011;493;1;0;0;0;494
AT31;40827;Schlüßlberg;2011;2824;68;28;19;6;2945
AT31;40828;Steegen;2011;1042;9;0;0;1;1052
AT31;40829;Taufkirchen an der Trattnach;2011;1954;23;6;7;6;1996
AT31;40830;Tollet;2011;889;15;0;2;1;907
AT31;40831;Waizenkirchen;2011;3481;60;51;28;7;3627
AT31;40832;Wallern an der Trattnach;2011;2719;79;24;27;12;2861
AT31;40833;Weibern;2011;1534;13;55;7;0;1609
AT31;40834;Wendling;2011;793;11;0;0;2;806
AT31;40835;Peuerbach;2011;4276;76;41;48;11;4452
AT31;40901;Edlbach;2011;622;22;4;0;0;648
AT31;40902;Grünburg;2011;3536;82;72;158;8;3856
AT31;40903;Hinterstoder;2011;845;53;12;0;1;911
AT31;40904;Inzersdorf im Kremstal;2011;1826;43;23;3;9;1904
AT31;40905;Kirchdorf an der Krems;2011;3685;177;171;18;37;4088
AT31;40906;Klaus an der Pyhrnbahn;2011;1020;61;15;0;8;1104
AT31;40907;Kremsmünster;2011;5750;407;256;12;32;6457
AT31;40908;Micheldorf in Oberösterreich;2011;5383;153;158;102;39;5835
AT31;40909;Molln;2011;3318;66;90;109;12;3595
AT31;40910;Nußbach;2011;2201;45;1;4;6;2257
AT31;40911;Oberschlierbach;2011;453;11;0;1;1;466
AT31;40912;Pettenbach;2011;4687;127;54;101;13;4982
AT31;40913;Ried im Traunkreis;2011;2564;48;12;17;5;2646
AT31;40914;Rosenau am Hengstpaß;2011;642;18;32;0;2;694
AT31;40915;Roßleithen;2011;1786;53;20;0;2;1861
AT31;40916;St. Pankraz;2011;319;13;9;0;7;348
AT31;40917;Schlierbach;2011;2644;77;29;5;18;2773
AT31;40918;Spital am Pyhrn;2011;2121;52;27;2;13;2215
AT31;40919;Steinbach am Ziehberg;2011;802;13;3;0;2;820
AT31;40920;Steinbach an der Steyr;2011;1916;27;4;16;5;1968
AT31;40921;Vorderstoder;2011;746;26;0;0;2;774
AT31;40922;Wartberg an der Krems;2011;2766;80;36;27;18;2927
AT31;40923;Windischgarsten;2011;2168;120;112;1;13;2414
AT31;41001;Allhaming;2011;1030;18;4;12;6;1070
AT31;41002;Ansfelden;2011;13102;742;794;475;524;15637
AT31;41003;Asten;2011;5620;267;160;86;71;6204
AT31;41004;Eggendorf im Traunkreis;2011;730;35;0;6;1;772
AT31;41005;Enns;2011;9695;488;787;220;181;11371
AT31;41006;Hargelsberg;2011;1198;36;0;0;0;1234
AT31;41007;Hörsching;2011;5331;241;104;78;40;5794
AT31;41008;Hofkirchen im Traunkreis;2011;1683;53;2;2;8;1748
AT31;41009;Kematen an der Krems;2011;2372;84;38;22;11;2527
AT31;41010;Kirchberg-Thening;2011;2244;35;9;2;9;2299
AT31;41011;Kronstorf;2011;2959;75;78;20;17;3149
AT31;41012;Leonding;2011;23155;1230;600;266;416;25667
AT31;41013;St. Florian;2011;5781;125;41;6;27;5980
AT31;41014;Neuhofen an der Krems;2011;5256;165;144;23;34;5622
AT31;41015;Niederneukirchen;2011;1874;21;13;0;11;1919
AT31;41016;Oftering;2011;1852;56;20;4;9;1941
AT31;41017;Pasching;2011;5918;305;190;83;77;6573
AT31;41018;Piberbach;2011;1777;51;10;0;9;1847
AT31;41019;Pucking;2011;3591;82;32;24;7;3736
AT31;41020;St. Marien;2011;4445;76;27;38;14;4600
AT31;41021;Traun;2011;19390;1200;1677;618;727;23612
AT31;41022;Wilhering;2011;5495;187;59;10;43;5794
AT31;41101;Allerheiligen im Mühlkreis;2011;1168;4;2;0;4;1178
AT31;41102;Arbing;2011;1310;23;9;6;8;1356
AT31;41103;Baumgartenberg;2011;1557;35;3;2;14;1611
AT31;41104;Dimbach;2011;1021;6;0;0;10;1037
AT31;41105;Grein;2011;2850;91;14;0;70;3025
AT31;41106;Katsdorf;2011;2754;67;0;0;11;2832
AT31;41107;Klam;2011;895;14;1;1;2;913
AT31;41108;Bad Kreuzen;2011;2193;21;12;1;150;2377
AT31;41109;Langenstein;2011;2336;42;22;43;33;2476
AT31;41110;Luftenberg an der Donau;2011;3755;71;27;14;18;3885
AT31;41111;Mauthausen;2011;4405;192;102;213;45;4957
AT31;41112;Mitterkirchen im Machland;2011;1667;18;0;11;2;1698
AT31;41113;Münzbach;2011;1612;80;29;4;5;1730
AT31;41114;Naarn im Machlande;2011;3348;69;38;55;7;3517
AT31;41115;Pabneukirchen;2011;1698;15;18;0;1;1732
AT31;41116;Perg;2011;7073;227;233;276;55;7864
AT31;41117;Rechberg;2011;914;10;6;0;1;931
AT31;41118;Ried in der Riedmark;2011;3999;42;5;23;6;4075
AT31;41119;St. Georgen am Walde;2011;2070;16;0;0;2;2088
AT31;41120;St. Georgen an der Gusen;2011;3513;53;24;38;13;3641
AT31;41121;St. Nikola an der Donau;2011;668;32;21;5;14;740
AT31;41122;St. Thomas am Blasenstein;2011;915;13;5;0;4;937
AT31;41123;Saxen;2011;1665;44;10;7;9;1735
AT31;41124;Schwertberg;2011;4780;126;62;133;22;5123
AT31;41125;Waldhausen im Strudengau;2011;2792;37;13;5;60;2907
AT31;41126;Windhaag bei Perg;2011;1367;30;41;6;4;1448
AT31;41201;Andrichsfurt;2011;702;7;0;0;2;711
AT31;41202;Antiesenhofen;2011;970;61;39;14;3;1087
AT31;41203;Aurolzmünster;2011;2746;46;30;63;9;2894
AT31;41204;Eberschwang;2011;3204;72;62;11;15;3364
AT31;41205;Eitzing;2011;705;13;1;4;3;726
AT31;41206;Geiersberg;2011;535;8;3;0;0;546
AT31;41207;Geinberg;2011;1333;40;6;10;7;1396
AT31;41208;Gurten;2011;1090;36;30;17;7;1180
AT31;41209;Hohenzell;2011;1990;34;17;3;4;2048
AT31;41210;Kirchdorf am Inn;2011;583;25;2;0;0;610
AT31;41211;Kirchheim im Innkreis;2011;682;15;1;0;9;707
AT31;41212;Lambrechten;2011;1265;22;6;0;1;1294
AT31;41213;Lohnsburg am Kobernaußerwald;2011;2125;59;0;3;6;2193
AT31;41214;Mehrnbach;2011;2207;57;18;10;7;2299
AT31;41215;Mettmach;2011;2369;54;5;4;2;2434
AT31;41216;Mörschwang;2011;302;7;0;0;2;311
AT31;41217;Mühlheim am Inn;2011;610;31;0;1;5;647
AT31;41218;Neuhofen im Innkreis;2011;2128;67;14;9;2;2220
AT31;41219;Obernberg am Inn;2011;1266;130;28;8;15;1447
AT31;41220;Ort im Innkreis;2011;1126;43;23;20;1;1213
AT31;41221;Pattigham;2011;870;8;3;0;2;883
AT31;41222;Peterskirchen;2011;665;10;1;1;0;677
AT31;41223;Pramet;2011;974;32;15;0;0;1021
AT31;41224;Reichersberg;2011;1336;92;15;13;4;1460
AT31;41225;Ried im Innkreis;2011;9761;454;513;487;153;11368
AT31;41226;St. Georgen bei Obernberg am Inn;2011;561;22;7;0;1;591
AT31;41227;St. Marienkirchen am Hausruck;2011;811;11;7;0;3;832
AT31;41228;St. Martin im Innkreis;2011;1526;178;59;7;15;1785
AT31;41229;Schildorn;2011;1096;13;0;0;0;1109
AT31;41230;Senftenbach;2011;694;26;0;8;3;731
AT31;41231;Taiskirchen im Innkreis;2011;2396;45;1;3;5;2450
AT31;41232;Tumeltsham;2011;1430;25;34;14;5;1508
AT31;41233;Utzenaich;2011;1465;51;23;2;2;1543
AT31;41234;Waldzell;2011;2038;37;1;4;2;2082
AT31;41235;Weilbach;2011;587;30;0;0;2;619
AT31;41236;Wippenham;2011;519;9;4;1;1;534
AT31;41304;Altenfelden;2011;2097;14;4;17;5;2137
AT31;41305;Arnreit;2011;1119;6;6;0;6;1137
AT31;41306;Atzesberg;2011;447;6;0;0;0;453
AT31;41307;Auberg;2011;580;7;0;0;5;592
AT31;41309;Haslach an der Mühl;2011;2449;42;6;13;8;2518
AT31;41311;Hörbich;2011;410;4;1;0;0;415
AT31;41312;Hofkirchen im Mühlkreis;2011;1396;30;4;0;7;1437
AT31;41313;Julbach;2011;1548;34;0;0;3;1585
AT31;41314;Kirchberg ob der Donau;2011;1043;12;0;0;0;1055
AT31;41315;Klaffer am Hochficht;2011;1250;51;0;0;1;1302
AT31;41316;Kleinzell im Mühlkreis;2011;1443;13;0;10;5;1471
AT31;41317;Kollerschlag;2011;1449;44;0;1;3;1497
AT31;41318;Lembach im Mühlkreis;2011;1490;26;28;1;18;1563
AT31;41319;Lichtenau im Mühlkreis;2011;512;6;0;0;1;519
AT31;41320;Nebelberg;2011;612;12;0;0;0;624
AT31;41321;Neufelden;2011;1179;16;45;0;37;1277
AT31;41322;Niederkappel;2011;971;4;0;0;0;975
AT31;41323;Niederwaldkirchen;2011;1732;18;0;4;5;1759
AT31;41324;Oberkappel;2011;654;34;0;0;38;726
AT31;41325;Oepping;2011;1525;6;6;0;1;1538
AT31;41326;Peilstein im Mühlviertel;2011;1566;23;0;0;1;1590
AT31;41327;Pfarrkirchen im Mühlkreis;2011;1441;42;0;0;25;1508
AT31;41328;Putzleinsdorf;2011;1486;31;18;0;7;1542
AT31;41329;Neustift im Mühlkreis;2011;1398;45;0;0;9;1452
AT31;41331;St. Johann am Wimberg;2011;981;16;0;2;4;1003
AT31;41332;St. Martin im Mühlkreis;2011;3537;35;2;39;8;3621
AT31;41333;St. Oswald bei Haslach;2011;491;7;0;0;0;498
AT31;41334;St. Peter am Wimberg;2011;1733;9;0;7;1;1750
AT31;41336;St. Ulrich im Mühlkreis;2011;653;4;0;6;3;666
AT31;41337;St. Veit im Mühlkreis;2011;1176;7;2;0;8;1193
AT31;41338;Sarleinsbach;2011;2198;19;0;0;10;2227
AT31;41341;Schwarzenberg am Böhmerwald;2011;575;57;2;0;3;637
AT31;41342;Ulrichsberg;2011;2875;68;0;6;10;2959
AT31;41343;Aigen-Schlägl;2011;3103;58;25;9;19;3214
AT31;41344;Rohrbach-Berg;2011;4809;98;58;11;42;5018
AT31;41345;Helfenberg;2011;1494;18;4;22;7;1545
AT31;41346;St. Stefan-Afiesl;2011;1108;12;1;0;4;1125
AT31;41401;Altschwendt;2011;653;4;0;2;5;664
AT31;41402;Andorf;2011;4818;82;46;76;32;5054
AT31;41403;Brunnenthal;2011;1830;110;9;14;9;1972
AT31;41404;Diersbach;2011;1558;36;1;10;6;1611
AT31;41405;Dorf an der Pram;2011;1012;17;2;1;0;1032
AT31;41406;Eggerding;2011;1216;25;0;0;5;1246
AT31;41407;Engelhartszell;2011;913;51;7;0;9;980
AT31;41408;Enzenkirchen;2011;1739;40;0;0;7;1786
AT31;41409;Esternberg;2011;2766;130;5;1;6;2908
AT31;41410;Freinberg;2011;1161;292;3;0;5;1461
AT31;41411;Kopfing im Innkreis;2011;1912;42;0;0;9;1963
AT31;41412;Mayrhof;2011;296;6;0;0;1;303
AT31;41413;Münzkirchen;2011;2488;44;6;4;9;2551
AT31;41414;Raab;2011;2185;47;8;23;4;2267
AT31;41415;Rainbach im Innkreis;2011;1488;22;0;7;7;1524
AT31;41416;Riedau;2011;1839;45;21;63;7;1975
AT31;41417;St. Aegidi;2011;1551;32;5;0;7;1595
AT31;41418;St. Florian am Inn;2011;2870;134;5;70;6;3085
AT31;41419;St. Marienkirchen bei Schärding;2011;1743;59;0;32;6;1840
AT31;41420;St. Roman;2011;1727;21;0;1;0;1749
AT31;41421;St. Willibald;2011;1087;25;0;0;1;1113
AT31;41422;Schärding;2011;4270;282;123;130;55;4860
AT31;41423;Schardenberg;2011;2042;237;8;0;12;2299
AT31;41424;Sigharting;2011;764;21;0;7;0;792
AT31;41425;Suben;2011;1212;101;48;29;50;1440
AT31;41426;Taufkirchen an der Pram;2011;2785;61;1;67;9;2923
AT31;41427;Vichtenstein;2011;566;90;7;0;25;688
AT31;41428;Waldkirchen am Wesen;2011;1187;25;1;0;4;1217
AT31;41429;Wernstein am Inn;2011;1405;129;4;0;6;1544
AT31;41430;Zell an der Pram;2011;1896;50;13;37;10;2006
AT31;41501;Adlwang;2011;1607;48;13;2;7;1677
AT31;41502;Aschach an der Steyr;2011;2194;20;0;0;6;2220
AT31;41503;Bad Hall;2011;4438;172;74;74;26;4784
AT31;41504;Dietach;2011;2814;89;65;13;10;2991
AT31;41505;Gaflenz;2011;1801;42;2;0;2;1847
AT31;41506;Garsten;2011;6385;128;57;29;62;6661
AT31;41507;Großraming;2011;2633;27;7;0;3;2670
AT31;41508;Laussa;2011;1266;9;0;0;0;1275
AT31;41509;Losenstein;2011;1591;35;3;0;4;1633
AT31;41510;Maria Neustift;2011;1623;5;0;0;3;1631
AT31;41511;Pfarrkirchen bei Bad Hall;2011;2073;34;15;10;9;2141
AT31;41512;Reichraming;2011;1772;17;2;0;3;1794
AT31;41513;Rohr im Kremstal;2011;1180;22;6;2;2;1212
AT31;41514;St. Ulrich bei Steyr;2011;2931;39;6;8;12;2996
AT31;41515;Schiedlberg;2011;1191;25;0;2;6;1224
AT31;41516;Sierning;2011;8533;182;161;76;83;9035
AT31;41517;Ternberg;2011;3236;47;3;2;14;3302
AT31;41518;Waldneukirchen;2011;2165;34;8;24;7;2238
AT31;41521;Wolfern;2011;2959;49;3;0;11;3022
AT31;41522;Weyer;2011;4108;64;24;2;27;4225
AT31;41601;Alberndorf in der Riedmark;2011;3790;59;8;2;10;3869
AT31;41602;Altenberg bei Linz;2011;4306;69;11;0;19;4405
AT31;41603;Bad Leonfelden;2011;3918;89;32;26;18;4083
AT31;41604;Eidenberg;2011;1999;36;1;1;6;2043
AT31;41605;Engerwitzdorf;2011;8333;145;14;1;34;8527
AT31;41606;Feldkirchen an der Donau;2011;5033;63;52;8;14;5170
AT31;41607;Gallneukirchen;2011;5933;125;71;12;32;6173
AT31;41608;Goldwörth;2011;914;7;5;0;5;931
AT31;41609;Gramastetten;2011;4622;90;4;4;28;4748
AT31;41610;Haibach im Mühlkreis;2011;845;25;0;0;3;873
AT31;41611;Hellmonsödt;2011;2092;41;11;6;15;2165
AT31;41612;Herzogsdorf;2011;2411;12;0;0;10;2433
AT31;41613;Kirchschlag bei Linz;2011;1935;68;1;1;17;2022
AT31;41614;Lichtenberg;2011;2535;37;1;1;11;2585
AT31;41615;Oberneukirchen;2011;3108;33;15;2;9;3167
AT31;41616;Ottenschlag im Mühlkreis;2011;505;5;0;0;1;511
AT31;41617;Ottensheim;2011;4287;112;30;11;72;4512
AT31;41618;Puchenau;2011;4273;121;7;1;40;4442
AT31;41619;Reichenau im Mühlkreis;2011;1220;15;1;0;6;1242
AT31;41620;Reichenthal;2011;1446;17;2;1;4;1470
AT31;41621;St. Gotthard im Mühlkreis;2011;1246;23;0;0;3;1272
AT31;41622;Schenkenfelden;2011;1515;12;5;0;4;1536
AT31;41623;Sonnberg im Mühlkreis;2011;861;5;0;0;1;867
AT31;41624;Steyregg;2011;4582;143;27;2;32;4786
AT31;41626;Walding;2011;3764;48;6;8;75;3901
AT31;41627;Zwettl an der Rodl;2011;1684;19;0;6;15;1724
AT31;41628;Vorderweißenbach;2011;2532;33;3;0;2;2570
AT31;41701;Ampflwang im Hausruckwald;2011;3196;106;47;22;93;3464
AT31;41702;Attersee am Attersee;2011;1488;67;2;0;31;1588
AT31;41703;Attnang-Puchheim;2011;7271;638;574;247;131;8861
AT31;41704;Atzbach;2011;1148;23;3;0;2;1176
AT31;41705;Aurach am Hongar;2011;1549;29;8;6;7;1599
AT31;41706;Berg im Attergau;2011;962;21;14;0;7;1004
AT31;41707;Desselbrunn;2011;1646;29;12;0;5;1692
AT31;41708;Fornach;2011;912;28;0;0;1;941
AT31;41709;Frankenburg am Hausruck;2011;4631;106;47;6;9;4799
AT31;41710;Frankenmarkt;2011;3225;117;68;58;30;3498
AT31;41711;Gampern;2011;2625;57;10;0;10;2702
AT31;41712;Innerschwand am Mondsee;2011;1066;45;4;0;5;1120
AT31;41713;Lenzing;2011;4624;151;143;16;94;5028
AT31;41714;Manning;2011;797;7;1;0;1;806
AT31;41715;Mondsee;2011;2777;266;199;10;54;3306
AT31;41716;Neukirchen an der Vöckla;2011;2438;38;8;1;3;2488
AT31;41717;Niederthalheim;2011;1002;15;0;11;2;1030
AT31;41718;Nußdorf am Attersee;2011;1008;62;22;0;13;1105
AT31;41719;Oberhofen am Irrsee;2011;1431;58;5;2;7;1503
AT31;41720;Oberndorf bei Schwanenstadt;2011;1358;25;23;4;4;1414
AT31;41721;Oberwang;2011;1564;20;9;1;4;1598
AT31;41722;Ottnang am Hausruck;2011;3702;121;12;7;10;3852
AT31;41723;Pfaffing;2011;1379;23;0;0;3;1405
AT31;41724;Pilsbach;2011;614;3;0;0;2;619
AT31;41725;Pitzenberg;2011;491;5;0;0;1;497
AT31;41726;Pöndorf;2011;2200;60;5;12;5;2282
AT31;41727;Puchkirchen am Trattberg;2011;937;24;1;0;2;964
AT31;41728;Pühret;2011;588;6;0;0;0;594
AT31;41729;Redleiten;2011;481;9;0;1;1;492
AT31;41730;Redlham;2011;1397;40;27;1;11;1476
AT31;41731;Regau;2011;5835;260;123;14;32;6264
AT31;41732;Rüstorf;2011;1885;30;33;6;8;1962
AT31;41733;Rutzenham;2011;249;5;0;0;0;254
AT31;41734;St. Georgen im Attergau;2011;3639;130;196;23;146;4134
AT31;41735;St. Lorenz;2011;2177;123;12;12;18;2342
AT31;41736;Schlatt;2011;1255;37;16;14;6;1328
AT31;41737;Schörfling am Attersee;2011;3038;129;20;2;16;3205
AT31;41738;Schwanenstadt;2011;3489;226;279;77;45;4116
AT31;41739;Seewalchen am Attersee;2011;5017;172;66;3;34;5292
AT31;41740;Steinbach am Attersee;2011;788;49;4;1;7;849
AT31;41741;Straß im Attergau;2011;1373;46;26;4;31;1480
AT31;41742;Tiefgraben;2011;3468;186;41;1;41;3737
AT31;41743;Timelkam;2011;5381;160;209;17;153;5920
AT31;41744;Ungenach;2011;1390;19;0;1;11;1421
AT31;41745;Unterach am Attersee;2011;1270;96;32;2;17;1417
AT31;41746;Vöcklabruck;2011;10413;603;471;72;350;11909
AT31;41747;Vöcklamarkt;2011;4381;156;129;51;27;4744
AT31;41748;Weißenkirchen im Attergau;2011;900;29;0;0;0;929
AT31;41749;Weyregg am Attersee;2011;1434;31;2;0;5;1472
AT31;41750;Wolfsegg am Hausruck;2011;1894;102;5;1;18;2020
AT31;41751;Zell am Moos;2011;1405;63;13;16;34;1531
AT31;41752;Zell am Pettenfirst;2011;1099;31;3;0;15;1148
AT31;41801;Aichkirchen;2011;516;9;12;3;3;543
AT31;41802;Bachmanning;2011;599;46;4;11;1;661
AT31;41803;Bad Wimsbach-Neydharting;2011;2332;53;37;21;7;2450
AT31;41804;Buchkirchen;2011;3882;69;18;16;13;3998
AT31;41805;Eberstalzell;2011;2224;37;49;7;8;2325
AT31;41806;Edt bei Lambach;2011;1883;64;41;15;4;2007
AT31;41807;Fischlham;2011;1285;25;0;2;3;1315
AT31;41808;Gunskirchen;2011;5349;259;79;16;11;5714
AT31;41809;Holzhausen;2011;751;29;0;1;3;784
AT31;41810;Krenglbach;2011;2882;60;21;7;13;2983
AT31;41811;Lambach;2011;2803;157;253;59;69;3341
AT31;41812;Marchtrenk;2011;11100;658;292;218;88;12356
AT31;41813;Neukirchen bei Lambach;2011;860;13;2;3;3;881
AT31;41814;Offenhausen;2011;1508;49;15;24;7;1603
AT31;41815;Pennewang;2011;862;15;1;0;0;878
AT31;41816;Pichl bei Wels;2011;2620;100;40;39;16;2815
AT31;41817;Sattledt;2011;2222;63;45;62;22;2414
AT31;41818;Schleißheim;2011;1174;42;5;2;7;1230
AT31;41819;Sipbachzell;2011;1729;49;12;9;7;1806
AT31;41820;Stadl-Paura;2011;4220;211;321;56;111;4919
AT31;41821;Steinerkirchen an der Traun;2011;2279;53;16;0;6;2354
AT31;41822;Steinhaus;2011;1836;43;5;1;10;1895
AT31;41823;Thalheim bei Wels;2011;5025;244;117;59;34;5479
AT31;41824;Weißkirchen an der Traun;2011;2966;78;15;22;62;3143
